mágico	adjetivo	[má]|gi|co
maginação	nome feminino	ma|gi|na|[ção]
maginar	verbo	ma|gi|[nar]
magismo	nome masculino	ma|[gis]|mo
magíster	nome masculino	ma|[gís]|ter
magistério	nome masculino	ma|gis|[té]|ri|o
magistrada	nome feminino	ma|gis|[tra]|da
magistrado	nome masculino	ma|gis|[tra]|do
magistral	adjetivo	ma|gis|[tral]
magistral	nome masculino	ma|gis|[tral]
magistralidade	nome feminino	ma|gis|tra|li|[da]|de
magistralmente	advérbio	ma|gis|tral|[men]|te
magistrando	nome masculino	ma|gis|[tran]|do
magistrático	adjetivo	ma|gis|[trá]|ti|co
magistratura	nome feminino	ma|gis|tra|[tu]|ra
magma	nome masculino	[mag]|ma
magmático	adjetivo	mag|[má]|ti|co
magmatismo	nome masculino	mag|ma|[tis]|mo
magnálio	nome masculino	mag|[ná]|li|o
magnanimamente	advérbio	mag|na|ni|ma|[men]|te
magnanimidade	nome feminino	mag|na|ni|mi|[da]|de
magnânimo	adjetivo	mag|[nâ]|ni|mo
magnata	nome masculino	mag|[na]|ta
magnata	nome feminino	mag|[na]|ta
magnate	nome masculino	mag|[na]|te
magnate	nome feminino	mag|[na]|te
magnatismo	nome masculino	mag|na|[tis]|mo
magnésia	nome feminino	mag|[né]|si|a
magnesiado	adjetivo	mag|ne|si|[a]|do
magnesiano	adjetivo	mag|ne|si|[a]|no
magnésico	adjetivo	mag|[né]|si|co
magnésio	nome masculino	mag|[né]|si|o
magnesioferrite	nome feminino	mag|ne|si|o|fer|[ri]|te
magnesita	nome feminino	mag|ne|[si]|ta
magnesite	nome feminino	mag|ne|[si]|te
magnesítico	adjetivo	mag|ne|[sí]|ti|co
magnetão	nome masculino	mag|ne|[tão]
magnete	nome masculino	mag|[ne]|te
magnete	nome feminino	mag|[ne]|te
magneteléctrico	adjetivo	mag|ne|te|[léc]|tri|co
magnetelétrico	adjetivo	mag|ne|te|[lé]|tri|co
magneticamente	advérbio	mag|ne|ti|ca|[men]|te
magnético	adjetivo	mag|[né]|ti|co
magnetismo	nome masculino	mag|ne|[tis]|mo
magnetista	adjetivo	mag|ne|[tis]|ta
magnetista	nome masculino	mag|ne|[tis]|ta
magnetista	nome feminino	mag|ne|[tis]|ta
magnetita	nome feminino	mag|ne|[ti]|ta
magnetite	nome feminino	mag|ne|[ti]|te
magnetítico	adjetivo	mag|ne|[tí]|ti|co
magnetização	nome feminino	mag|ne|ti|za|[ção]
magnetizado	adjetivo	mag|ne|ti|[za]|do
magnetizador	adjetivo	mag|ne|ti|za|[dor]
magnetizador	nome masculino	mag|ne|ti|za|[dor]
magnetizadora	nome feminino	mag|ne|ti|za|[do]|ra
magnetizante	adjetivo	mag|ne|ti|[zan]|te
magnetizar	verbo	mag|ne|ti|[zar]
magnetizável	adjetivo	mag|ne|ti|[zá]|vel
magneto	nome masculino	mag|[ne]|to
magneto-hidrodinâmica	nome feminino	mag|ne|to-hi|dro|di|[nâ]|mi|ca
magnetocalórico	adjetivo	mag|ne|to|ca|[ló]|ri|co
magnetofone	nome masculino	mag|ne|to|[fo]|ne
magnetofônico	adjetivo	mag|ne|to|[fô]|ni|co
magnetofónico	adjetivo	mag|ne|to|[fó]|ni|co
magnetogenia	nome feminino	mag|ne|to|ge|[ni]|a
magnetogênico	adjetivo	mag|ne|to|[gê]|ni|co
magnetogénico	adjetivo	mag|ne|to|[gé]|ni|co
magnetógeno	adjetivo	mag|ne|[tó]|ge|no
magnetógrafo	nome masculino	mag|ne|[tó]|gra|fo
magnetograma	nome masculino	mag|ne|to|[gra]|ma
magnetoide	adjetivo	mag|ne|[toi]|de
magnetoidrodinâmica	nome feminino	mag|ne|toi|dro|di|[nâ]|mi|ca
magnetologia	nome feminino	mag|ne|to|lo|[gi]|a
magnetológico	adjetivo	mag|ne|to|[ló]|gi|co
magnetometria	nome feminino	mag|ne|to|me|[tri]|a
magnetométrico	adjetivo	mag|ne|to|[mé]|tri|co
magnetômetro	nome masculino	mag|ne|[tô]|me|tro
magnetómetro	nome masculino	mag|ne|[tó]|me|tro
magnetopirite	nome feminino	mag|ne|to|pi|[ri]|te
magnetopolar	adjetivo	mag|ne|to|po|[lar]
magnetoquímica	nome feminino	mag|ne|to|[quí]|mi|ca
magnetoquímico	adjetivo	mag|ne|to|[quí]|mi|co
magnetorresistência	nome feminino	mag|ne|tor|re|sis|[tên]|ci|a
magnetoscópico	adjetivo	mag|ne|tos|[có]|pi|co
magnetoscópio	nome masculino	mag|ne|tos|[có]|pi|o
magnetostática	nome feminino	mag|ne|tos|[tá]|ti|ca
magnetostático	adjetivo	mag|ne|tos|[tá]|ti|co
magnetostrição	nome feminino	mag|ne|tos|tri|[ção]
magnetotecnia	nome feminino	mag|ne|to|tec|[ni]|a
magnetotécnico	adjetivo	mag|ne|to|[téc]|ni|co
magnetoterapia	nome feminino	mag|ne|to|te|ra|[pi]|a
magnetoterápico	adjetivo	mag|ne|to|te|[rá]|pi|co
magnetrão	nome masculino	mag|ne|[trão]
magnicida	nome masculino	mag|ni|[ci]|da
magnicida	nome feminino	mag|ni|[ci]|da
magnicídio	nome masculino	mag|ni|[cí]|di|o
magnífica	nome feminino	mag|[ní]|fi|ca
magnificação	nome feminino	mag|ni|fi|ca|[ção]
magnificador	adjetivo	mag|ni|fi|ca|[dor]
magnificador	nome masculino	mag|ni|fi|ca|[dor]
