anfigénio	nome masculino	an|fi|[gé]|ni|o
anfigênio	nome masculino	an|fi|[gê]|ni|o
anfigenite	nome feminino	an|fi|ge|[ni]|te
anfígeno	adjetivo	an|[fí]|ge|no
anfiglossa	nome feminino	an|fi|[glos]|sa
anfigonia	nome feminino	an|fi|go|[ni]|a
anfigónico	adjetivo	an|fi|[gó]|ni|co
anfigônico	adjetivo	an|fi|[gô]|ni|co
anfiguri	nome masculino	an|fi|gu|[ri]
anfiguricamente	advérbio	an|fi|gu|ri|ca|[men]|te
anfigúrico	adjetivo	an|fi|[gú]|ri|co
anfigurismo	nome masculino	an|fi|gu|[ris]|mo
anfiguriticamente	advérbio	an|fi|gu|ri|ti|ca|[men]|te
anfigurítico	adjetivo	an|fi|gu|[rí]|ti|co
anfíloco	adjetivo	an|[fí]|lo|co
anfíloco	nome masculino	an|[fí]|lo|co
anfílofo	nome masculino	an|[fí]|lo|fo
anfímacro	nome masculino	an|[fí]|ma|cro
anfimétrico	adjetivo	an|fi|[mé]|tri|co
anfimixia	nome feminino	an|fi|mi|[xi]|a
anfineuro	nome masculino	an|fi|[neu]|ro
anfineuro	adjetivo	an|fi|[neu]|ro
anfiônio	adjetivo	an|fi|[ô]|ni|o
anfiónio	adjetivo	an|fi|[ó]|ni|o
anfioxo	nome masculino	an|fi|[o]|xo
anfipneusto	nome masculino	an|fip|[neus]|to
anfípode	adjetivo	an|[fí]|po|de
anfípode	nome masculino	an|[fí]|po|de
anfipogão	nome masculino	an|fi|po|[gão]
anfipolitano	adjetivo	an|fi|po|li|[ta]|no
anfipolitano	nome masculino	an|fi|po|li|[ta]|no
anfíporo	nome masculino	an|[fí]|po|ro
anfiprostilo	nome masculino	an|fi|pros|[ti]|lo
anfíptero	nome masculino	an|[fíp]|te|ro
anfisarca	nome masculino	an|fi|[sar]|ca
anfisbena	nome feminino	an|fis|[be]|na
anfíscio	nome masculino	an|[fís]|ci|o
anfisseu	adjetivo	an|fis|[seu]
anfisseu	nome masculino	an|fis|[seu]
anfístomo	nome masculino	an|[fís]|to|mo
anfitálamo	nome masculino	an|fi|[tá]|la|mo
anfiteatral	adjetivo	an|fi|te|a|[tral]
anfiteátrico	adjetivo	an|fi|te|[á]|tri|co
anfiteatro	nome masculino	an|fi|te|[a]|tro
anfiteísmo	nome masculino	an|fi|te|[ís]|mo
anfitriã	nome feminino	an|fi|tri|[ã]
anfitrião	nome masculino	an|fi|tri|[ão]
anfitrioa	nome feminino	an|fi|tri|[o]|a
anfitriônico	adjetivo	an|fi|tri|[ô]|ni|co
anfitriónico	adjetivo	an|fi|tri|[ó]|ni|co
anfitriônio	adjetivo	an|fi|tri|[ô]|ni|o
anfitriónio	adjetivo	an|fi|tri|[ó]|ni|o
anfitrite	nome feminino	an|fi|[tri]|te
anfitropia	nome feminino	an|fi|tro|[pi]|a
anfitrópico	adjetivo	an|fi|[tró]|pi|co
anfítropo	adjetivo	an|[fí]|tro|po
anfodiplopia	nome feminino	an|fo|di|plo|[pi]|a
anfófilo	adjetivo	an|[fó]|fi|lo
anfólito	adjetivo	an|[fó]|li|to
ânfora	nome feminino	[ân]|fo|ra
anforal	adjetivo	an|fo|[ral]
anforeta	nome feminino	an|fo|[re]|ta
anforicidade	nome feminino	an|fo|ri|ci|[da]|de
anfórico	adjetivo	an|[fó]|ri|co
anfotérico	adjetivo	an|fo|[té]|ri|co
anfótero	adjetivo	an|[fó]|te|ro
anfracto	adjetivo	an|[frac]|to
anfractuosidade	nome feminino	an|frac|tu|o|si|[da]|de
anfractuoso	adjetivo	an|frac|tu|[o]|so
angaíba	nome feminino	an|ga|[í]|ba
angala	nome masculino	an|[ga]|la
angana	nome feminino	an|[ga]|na
angareira	nome feminino	an|ga|[rei]|ra
angarela	nome feminino	an|ga|[re]|la
angária	nome feminino	an|[gá]|ri|a
angariação	nome feminino	an|ga|ri|a|[ção]
angariador	nome masculino	an|ga|ri|a|[dor]
angariador	adjetivo	an|ga|ri|a|[dor]
angariadora	nome feminino	an|ga|ri|a|[do]|ra
angariar	verbo	an|ga|ri|[ar]
angariári	nome masculino	an|ga|ri|[á]|ri
angariável	adjetivo	an|ga|ri|[á]|vel
angarilha	nome feminino	an|ga|[ri]|lha
angelato	nome masculino	an|ge|[la]|to
angélia	nome feminino	an|[gé]|li|a
angélica	nome feminino	an|[gé]|li|ca
angelica	nome feminino	an|ge|[li]|ca
angélica-silvestre	nome feminino	an|gé|li|ca-sil|[ves]|tre
angelical	adjetivo	an|ge|li|[cal]
angelicalmente	advérbio	an|ge|li|cal|[men]|te
angelicamente	advérbio	an|ge|li|ca|[men]|te
angelícea	nome feminino	an|ge|[lí]|ce|a
angelícico	adjetivo	an|ge|[lí]|ci|co
angélico	adjetivo	an|[gé]|li|co
angélico	nome masculino	an|[gé]|li|co
angelim	nome masculino	an|ge|[lim]
angelina	nome feminino	an|ge|[li]|na
angelino	adjetivo	an|ge|[li]|no
angelismo	nome masculino	an|ge|[lis]|mo
angelita	nome masculino	an|ge|[li]|ta
