abstencionista	nome masculino	abs|ten|ci|o|[nis]|ta
abstencionista	nome feminino	abs|ten|ci|o|[nis]|ta
abstencionístico	adjetivo	abs|ten|ci|o|[nís]|ti|co
abster	verbo	abs|[ter]
abstergência	nome feminino	abs|ter|[gên]|ci|a
abstergente	nome masculino	abs|ter|[gen]|te
abstergente	adjetivo	abs|ter|[gen]|te
absterger	verbo	abs|ter|[ger]
absterrâneo	adjetivo	abs|ter|[râ]|ne|o
absterrâneo	nome masculino	abs|ter|[râ]|ne|o
abstersão	nome feminino	abs|ter|[são]
abstersivo	adjetivo	abs|ter|[si]|vo
abstersivo	nome masculino	abs|ter|[si]|vo
absterso	adjetivo	abs|[ter]|so
abstido	adjetivo	abs|[ti]|do
abstinência	nome feminino	abs|ti|[nên]|ci|a
abstinente	adjetivo	abs|ti|[nen]|te
abstinente	nome masculino	abs|ti|[nen]|te
abstinente	nome feminino	abs|ti|[nen]|te
abstinentemente	advérbio	abs|ti|nen|te|[men]|te
abstração	nome feminino	abs|tra|[ção]
abstracionismo	nome masculino	abs|tra|ci|o|[nis]|mo
abstracionista	adjetivo	abs|tra|ci|o|[nis]|ta
abstracionista	nome masculino	abs|tra|ci|o|[nis]|ta
abstracionista	nome feminino	abs|tra|ci|o|[nis]|ta
abstraidamente	advérbio	abs|trai|da|[men]|te
abstraído	adjetivo	abs|tra|[í]|do
abstraidor	adjetivo	abs|trai|[dor]
abstraidor	nome masculino	abs|trai|[dor]
abstraimento	nome masculino	abs|trai|[men]|to
abstrair	verbo	abs|tra|[ir]
abstrata	nome feminino	abs|[tra]|ta
abstratamente	advérbio	abs|tra|ta|[men]|te
abstratício	adjetivo	abs|tra|[tí]|ci|o
abstratismo	nome masculino	abs|tra|[tis]|mo
abstrativamente	advérbio	abs|tra|ti|va|[men]|te
abstrativismo	nome masculino	abs|tra|ti|[vis]|mo
abstrativo	adjetivo	abs|tra|[ti]|vo
abstratizado	adjetivo	abs|tra|ti|[za]|do
abstratizante	adjetivo	abs|tra|ti|[zan]|te
abstratizar	verbo	abs|tra|ti|[zar]
abstrato	adjetivo	abs|[tra]|to
abstrato	nome masculino	abs|[tra]|to
abstrator	adjetivo	abs|tra|[tor]
abstrator	nome masculino	abs|tra|[tor]
abstruir	verbo	abs|tru|[ir]
abstrusamente	advérbio	abs|tru|sa|[men]|te
abstrusão	nome feminino	abs|tru|[são]
abstrusidade	nome feminino	abs|tru|si|[da]|de
abstrusivo	adjetivo	abs|tru|[si]|vo
abstruso	adjetivo	abs|[tru]|so
absunção	nome feminino	ab|sun|[ção]
absurdamente	advérbio	ab|sur|da|[men]|te
absurdez	nome feminino	ab|sur|[dez]
absurdeza	nome feminino	ab|sur|[de]|za
absurdidade	nome feminino	ab|sur|di|[da]|de
absurdismo	nome masculino	ab|sur|[dis]|mo
absurdista	adjetivo	ab|sur|[dis]|ta
absurdista	nome masculino	ab|sur|[dis]|ta
absurdista	nome feminino	ab|sur|[dis]|ta
absurdo	nome masculino	ab|[sur]|do
absurdo	adjetivo	ab|[sur]|do
abu	nome masculino	a|[bu]
abuamado	adjetivo	a|bu|a|[ma]|do
abugrado	adjetivo	a|bu|[gra]|do
abuitre	nome masculino	a|[bui]|tre
abular	verbo	a|bu|[lar]
abulia	nome feminino	a|bu|[li]|a
abúlica	nome feminino	a|[bú]|li|ca
abulicamente	advérbio	a|bu|li|ca|[men]|te
abúlico	adjetivo	a|[bú]|li|co
abúlico	nome masculino	a|[bú]|li|co
abuna	nome masculino	a|[bu]|na
abunã	nome feminino	a|bu|[nã]
abundança	nome feminino	a|bun|[dan]|ça
abundância	nome feminino	a|bun|[dân]|ci|a
abundancial	adjetivo	a|bun|dan|ci|[al]
abundanciar	verbo	a|bun|dan|ci|[ar]
abundante	adjetivo	a|bun|[dan]|te
abundantemente	advérbio	a|bun|dan|te|[men]|te
abundar	verbo	a|bun|[dar]
abundeza	nome feminino	a|bun|[de]|za
abundosamente	advérbio	a|bun|do|sa|[men]|te
abundoso	adjetivo	a|bun|[do]|so
abunhação	nome feminino	a|bu|nha|[ção]
abunhadio	nome masculino	a|bu|nha|[di]|o
abunhado	nome masculino	a|bu|[nha]|do
abunhar	verbo	a|bu|[nhar]
aburacar	verbo	a|bu|ra|[car]
aburelado	adjetivo	a|bu|re|[la]|do
aburelar	verbo	a|bu|re|[lar]
aburguesado	adjetivo	a|bur|gue|[sa]|do
aburguesamento	nome masculino	a|bur|gue|sa|[men]|to
aburguesar	verbo	a|bur|gue|[sar]
aburguesável	adjetivo	a|bur|gue|[sá]|vel
aburilado	adjetivo	a|bu|ri|[la]|do
aburilar	verbo	a|bu|ri|[lar]
aburrar	verbo	a|bur|[rar]
aburu	nome masculino	a|bu|[ru]
abusadamente	advérbio	a|bu|sa|da|[men]|te
