araçázada	nome feminino	a|ra|[çá]|za|da
araçazal	nome masculino	a|ra|ça|[zal]
araçazeiro	nome masculino	a|ra|ça|[zei]|ro
araçazinho	nome masculino	a|ra|ça|[zi]|nho
aracê	nome masculino	a|ra|[cê]
arácea	nome feminino	a|[rá]|ce|a
araceno	adjetivo	a|ra|[ce]|no
araceno	nome masculino	a|ra|[ce]|no
aráceo	adjetivo	a|[rá]|ce|o
arache	nome masculino	a|[ra]|che
araci	adjetivo	a|ra|[ci]
araci	nome masculino	a|ra|[ci]
araci	nome feminino	a|ra|[ci]
aracirana	nome feminino	a|ra|ci|[ra]|na
aracneólito	nome masculino	a|rac|ne|[ó]|li|to
aracniano	adjetivo	a|rac|ni|[a]|no
aracnícola	nome masculino	a|rac|[ní]|co|la
aracnícola	nome feminino	a|rac|[ní]|co|la
aracnicultor	nome masculino	a|rac|ni|cul|[tor]
aracnicultura	nome feminino	a|rac|ni|cul|[tu]|ra
aracnídeo	nome masculino	a|rac|[ní]|de|o
aracnídeo	adjetivo	a|rac|[ní]|de|o
aracnismo	nome masculino	a|rac|[nis]|mo
aracnodactilia	nome feminino	a|rac|no|dac|ti|[li]|a
aracnodérmico	adjetivo	a|rac|no|[dér]|mi|co
aracnodermo	adjetivo	a|rac|no|[der]|mo
aracnofilia	nome feminino	a|rac|no|fi|[li]|a
aracnófilo	adjetivo	a|rac|[nó]|fi|lo
aracnófilo	nome masculino	a|rac|[nó]|fi|lo
aracnofobia	nome feminino	a|rac|no|fo|[bi]|a
aracnografia	nome feminino	a|rac|no|gra|[fi]|a
aracnográfico	adjetivo	a|rac|no|[grá]|fi|co
aracnoide	nome feminino	a|rac|[noi]|de
aracnoide	adjetivo	a|rac|[noi]|de
aracnóideia	nome feminino	a|rac|[nói]|dei|a
aracnóideo	adjetivo	a|rac|[nói]|de|o
aracnoidiano	adjetivo	a|rac|noi|di|[a]|no
aracnoidite	nome feminino	a|rac|noi|[di]|te
aracnologia	nome feminino	a|rac|no|lo|[gi]|a
aracnológico	adjetivo	a|rac|no|[ló]|gi|co
aracnólogo	nome masculino	a|rac|[nó]|lo|go
aracnopsia	nome feminino	a|rac|nop|[si]|a
araçoia	nome feminino	a|ra|[çoi]|a
aracósio	adjetivo	a|ra|[có]|si|o
aracósio	nome masculino	a|ra|[có]|si|o
aracota	adjetivo	a|ra|[co]|ta
aracota	nome masculino	a|ra|[co]|ta
aracota	nome feminino	a|ra|[co]|ta
aracu	nome masculino	a|ra|[cu]
aracuí	nome masculino	a|ra|cu|[í]
aracuri	nome masculino	a|ra|cu|[ri]
arada	nome feminino	a|[ra]|da
aradar	verbo	a|ra|[dar]
arádega	nome feminino	a|[rá]|de|ga
aradeira	nome feminino	a|ra|[dei]|ra
aradessa	nome feminino	a|ra|[des]|sa
arádio	adjetivo	a|[rá]|di|o
arádio	nome masculino	a|[rá]|di|o
arado	adjetivo	a|[ra]|do
arado	nome masculino	a|[ra]|do
arador	nome masculino	a|ra|[dor]
aradoura	nome feminino	a|ra|[dou]|ra
aradouro	nome masculino	a|ra|[dou]|ro
aradura	nome feminino	a|ra|[du]|ra
aragano	adjetivo	a|ra|[ga]|no
aragano	nome masculino	a|ra|[ga]|no
aragão	nome masculino	a|ra|[gão]
aragem	nome feminino	a|[ra]|gem
arágoa	nome feminino	a|[rá]|go|a
aragoês	adjetivo	a|ra|go|[ês]
aragoês	nome masculino	a|ra|go|[ês]
aragonês	nome masculino	a|ra|go|[nês]
aragonês	adjetivo	a|ra|go|[nês]
aragonesa	nome feminino	a|ra|go|[ne]|sa
aragonita	nome feminino	a|ra|go|[ni]|ta
aragonite	nome feminino	a|ra|go|[ni]|te
araguaguá	nome masculino	a|ra|gua|[guá]
araguaí	nome masculino	a|ra|gua|[í]
araguari	nome masculino	a|ra|gua|[ri]
araguato	nome masculino	a|ra|[gua]|to
araiané	interjeição	a|rai|a|[né]
araicá	adjetivo	a|rai|[cá]
araicá	nome masculino	a|rai|[cá]
araicá	nome feminino	a|rai|[cá]
aral	nome masculino	a|[ral]
aralha	nome feminino	a|[ra]|lha
arália	nome feminino	a|[rá]|li|a
araliácea	nome feminino	a|ra|li|[á]|ce|a
araliáceo	adjetivo	a|ra|li|[á]|ce|o
aralina	nome feminino	a|ra|[li]|na
aramá	nome masculino	a|ra|[má]
aramaçá	nome masculino	a|ra|ma|[çá]
aramado	adjetivo	a|ra|[ma]|do
aramador	nome masculino	a|ra|ma|[dor]
aramagem	nome feminino	a|ra|[ma]|gem
aramaico	nome masculino	a|ra|[mai]|co
aramaico	adjetivo	a|ra|[mai]|co
aramar	verbo	a|ra|[mar]
aramata	nome feminino	a|ra|[ma]|ta
arame	nome masculino	a|[ra]|me
