arameia	nome feminino	a|ra|[mei]|a
arameira	nome feminino	a|ra|[mei]|ra
arameiro	nome masculino	a|ra|[mei]|ro
arameísmo	nome masculino	a|ra|me|[ís]|mo
aramenha	nome feminino	a|ra|[me]|nha
aramês	adjetivo	a|ra|[mês]
aramês	nome masculino	a|ra|[mês]
arameu	adjetivo	a|ra|[meu]
arameu	nome masculino	a|ra|[meu]
arâmico	adjetivo	a|[râ]|mi|co
arâmico	nome masculino	a|[râ]|mi|co
aramídeo	nome masculino	a|ra|[mí]|de|o
aramídeo	adjetivo	a|ra|[mí]|de|o
aramídeo	nome masculino	a|ra|[mí]|de|o
aramista	nome masculino	a|ra|[mis]|ta
aramista	nome feminino	a|ra|[mis]|ta
aramoso	adjetivo	a|ra|[mo]|so
aranã	adjetivo	a|ra|[nã]
aranã	nome masculino	a|ra|[nã]
aranã	nome feminino	a|ra|[nã]
arancim	nome masculino	a|ran|[cim]
arancu	nome masculino	a|ran|[cu]
arandeiro	nome masculino	a|ran|[dei]|ro
arandela	nome feminino	a|ran|[de]|la
aranditano	adjetivo	a|ran|di|[ta]|no
aranditano	nome masculino	a|ran|di|[ta]|no
arando	nome masculino	a|[ran]|do
araneídeo	nome masculino	a|ra|ne|[í]|de|o
araneídeo	adjetivo	a|ra|ne|[í]|de|o
araneífero	adjetivo	a|ra|ne|[í]|fe|ro
araneiforme	adjetivo	a|ra|nei|[for]|me
arâneo	adjetivo	a|[râ]|ne|o
araneografia	nome feminino	a|ra|ne|o|gra|[fi]|a
araneográfico	adjetivo	a|ra|ne|o|[grá]|fi|co
araneologia	nome feminino	a|ra|ne|o|lo|[gi]|a
araneológico	adjetivo	a|ra|ne|o|[ló]|gi|co
araneólogo	nome masculino	a|ra|ne|[ó]|lo|go
araneoso	adjetivo	a|ra|ne|[o]|so
aranganho	nome masculino	a|ran|[ga]|nho
aranha	nome feminino	a|[ra]|nha
aranha	nome masculino	a|[ra]|nha
aranha-do-mar	nome feminino	a|ra|nha-do-mar
aranha-do-mar	nome masculino	a|ra|nha-do-mar
aranhagato	nome masculino	a|ra|nha|[ga]|to
aranhão	nome masculino	a|ra|[nhão]
aranheira	nome feminino	a|ra|[nhei]|ra
aranheiro	nome masculino	a|ra|[nhei]|ro
aranhento	adjetivo	a|ra|[nhen]|to
aranhiço	nome masculino	a|ra|[nhi]|ço
aranhol	nome masculino	a|ra|[nhol]
aranhola	nome feminino	a|ra|[nho]|la
aranhoso	adjetivo	a|ra|[nho]|so
aranhota	nome feminino	a|ra|[nho]|ta
aranhoto	nome masculino	a|ra|[nho]|to
aranhuço	nome masculino	a|ra|[nhu]|ço
aranhudo	adjetivo	a|ra|[nhu]|do
aranzel	nome masculino	a|ran|[zel]
arão	nome masculino	a|[rão]
arapaçu	nome masculino	a|ra|pa|[çu]
arapapá	nome masculino	a|ra|pa|[pá]
arapene	nome masculino	a|ra|[pe]|ne
arapinga	nome feminino	a|ra|[pin]|ga
arapiraca	nome feminino	a|ra|pi|[ra]|ca
arapoca	nome feminino	a|ra|[po]|ca
araponga	nome feminino	a|ra|[pon]|ga
arapuá	nome masculino	a|ra|pu|[á]
arapuca	nome feminino	a|ra|[pu]|ca
arapuê	nome masculino	a|ra|pu|[ê]
araquã	nome masculino	a|ra|qu|[ã]
araquã	nome feminino	a|ra|qu|[ã]
araquãí	nome masculino	a|ra|qu|ã|[í]
araque	nome masculino	a|[ra]|que
aráquide	nome feminino	a|[rá]|qui|de
araquídeo	adjetivo	a|ra|[quí]|de|o
araquídico	adjetivo	a|ra|[quí]|di|co
araquina	nome feminino	a|ra|[qui]|na
araquita	adjetivo	a|ra|[qui]|ta
araquita	nome masculino	a|ra|[qui]|ta
araquita	nome feminino	a|ra|[qui]|ta
arar	verbo	a|[rar]
arar	nome masculino	a|[rar]
arará	nome masculino	a|ra|[rá]
arara	nome feminino	a|[ra]|ra
araraboia	nome feminino	a|ra|ra|[boi]|a
araracanga	nome feminino	a|ra|ra|[can]|ga
araracangaçu	nome masculino	a|ra|ra|can|ga|[çu]
ararama	nome feminino	a|ra|[ra]|ma
araramboia	nome feminino	a|ra|ram|[boi]|a
araranã	nome masculino	a|ra|ra|[nã]
ararandéua	nome feminino	a|ra|ran|[déu]|a
ararapá	nome masculino	a|ra|ra|[pá]
ararapiranga	nome feminino	a|ra|ra|pi|[ran]|ga
araraúna	nome feminino	a|ra|ra|[ú]|na
arari	nome masculino	a|ra|[ri]
araribá	nome feminino	a|ra|ri|[bá]
araribina	nome feminino	a|ra|ri|[bi]|na
araribuna	nome feminino	a|ra|ri|[bu]|na
ararinha	nome feminino	a|ra|[ri]|nha
araroba	nome feminino	a|ra|[ro]|ba
araruá	adjetivo	a|ra|ru|[á]
