ave-do-paraíso	nome feminino	a|ve-do-pa|ra|[í]|so
ave-fria	nome feminino	a|ve-fri|a
ave-lira	nome feminino	a|ve-li|ra
ave-maria	nome feminino	a|ve-ma|[ri]|a
ave-mosca	nome feminino	a|ve-mos|ca
ave-real	nome feminino	a|ve-re|[al]
aveado	adjetivo	a|ve|[a]|do
aveal	nome masculino	a|ve|[al]
aveão	nome masculino	a|ve|[ão]
avecoinha	nome feminino	a|ve|co|[i]|nha
aveia	nome feminino	a|[vei]|a
aveirense	nome masculino	a|vei|[ren]|se
aveirense	adjetivo	a|vei|[ren]|se
aveirense	nome feminino	a|vei|[ren]|se
avejão	nome masculino	a|ve|[jão]
avejão	nome feminino	a|ve|[jão]
avelã	nome feminino	a|ve|[lã]
avelã-da-índia	nome feminino	a|ve|lã-da-ín|di|a
avelado	adjetivo	a|ve|[la]|do
avelal	nome masculino	a|ve|[lal]
avelamento	nome masculino	a|ve|la|[men]|to
avelanado	adjetivo	a|ve|la|[na]|do
avelanal	nome masculino	a|ve|la|[nal]
avelaneira	nome feminino	a|ve|la|[nei]|ra
avelar	nome masculino	a|ve|[lar]
avelar	verbo	a|ve|[lar]
avelãzeira	nome feminino	a|ve|[lã]|zei|ra
aveleira	nome feminino	a|ve|[lei]|ra
aveleiral	nome masculino	a|ve|lei|[ral]
avelhacado	adjetivo	a|ve|lha|[ca]|do
avelhacar	verbo	a|ve|lha|[car]
avelhado	adjetivo	a|ve|[lha]|do
avelhar	verbo	a|ve|[lhar]
avelhentado	adjetivo	a|ve|lhen|[ta]|do
avelhentador	adjetivo	a|ve|lhen|ta|[dor]
avelhentador	nome masculino	a|ve|lhen|ta|[dor]
avelhentar	verbo	a|ve|lhen|[tar]
avelhuscado	adjetivo	a|ve|lhus|[ca]|do
avelino	nome masculino	a|ve|[li]|no
avelórios	nome masculino	a|ve|[ló]|ri|os
aveludadeira	nome feminino	a|ve|lu|da|[dei]|ra
aveludado	adjetivo	a|ve|lu|[da]|do
aveludadora	nome feminino	a|ve|lu|da|[do]|ra
aveludar	verbo	a|ve|lu|[dar]
avena	nome feminino	a|[ve]|na
avenáceo	adjetivo	a|ve|[ná]|ce|o
avenado	adjetivo	a|ve|[na]|do
avenaína	nome feminino	a|ve|na|[í]|na
avenal	nome masculino	a|ve|[nal]
avença	nome feminino	a|[ven]|ça
avenca	nome feminino	a|[ven]|ca
avençado	adjetivo	a|ven|[ça]|do
avençal	nome masculino	a|ven|[çal]
avençal	adjetivo	a|ven|[çal]
avençal	nome feminino	a|ven|[çal]
avencão	nome masculino	a|ven|[cão]
avençar	verbo	a|ven|[çar]
avenenar	verbo	a|ve|ne|[nar]
avenida	nome feminino	a|ve|[ni]|da
aveniforme	adjetivo	a|ve|ni|[for]|me
avenina	nome feminino	a|ve|[ni]|na
avenose	nome feminino	a|ve|[no]|se
avense	nome feminino	a|[ven]|se
avense	nome masculino	a|[ven]|se
avense	adjetivo	a|[ven]|se
aventador	nome masculino	a|ven|ta|[dor]
avental	nome masculino	a|ven|[tal]
aventamento	nome masculino	a|ven|ta|[men]|to
aventar	verbo	a|ven|[tar]
aventesma	nome masculino	a|ven|[tes]|ma
aventesma	nome feminino	a|ven|[tes]|ma
aventura	nome feminino	a|ven|[tu]|ra
aventurado	adjetivo	a|ven|tu|[ra]|do
aventurar	verbo	a|ven|tu|[rar]
aventureira	nome feminino	a|ven|tu|[rei]|ra
aventureiramente	advérbio	a|ven|tu|rei|ra|[men]|te
aventureirismo	nome masculino	a|ven|tu|rei|[ris]|mo
aventureiro	adjetivo	a|ven|tu|[rei]|ro
aventureiro	nome masculino	a|ven|tu|[rei]|ro
aventurina	nome feminino	a|ven|tu|[ri]|na
aventurinado	adjetivo	a|ven|tu|ri|[na]|do
aventurosamente	advérbio	a|ven|tu|ro|sa|[men]|te
aventuroso	adjetivo	a|ven|tu|[ro]|so
averano	nome masculino	a|ve|[ra]|no
averbação	nome feminino	a|ver|ba|[ção]
averbado	adjetivo	a|ver|[ba]|do
averbador	adjetivo	a|ver|ba|[dor]
averbador	nome masculino	a|ver|ba|[dor]
averbamento	nome masculino	a|ver|ba|[men]|to
averbar	verbo	a|ver|[bar]
averbável	adjetivo	a|ver|[bá]|vel
averdengado	adjetivo	a|ver|den|[ga]|do
averdugada	nome feminino	a|ver|du|[ga]|da
averdugado	adjetivo	a|ver|du|[ga]|do
averdugar	verbo	a|ver|du|[gar]
averdungado	adjetivo	a|ver|dun|[ga]|do
avergalhar	verbo	a|ver|ga|[lhar]
avergar	verbo	a|ver|[gar]
avergir	verbo	a|ver|[gir]
avergoar	verbo	a|ver|go|[ar]
