afervorador	nome masculino	a|fer|vo|ra|[dor]
afervoramento	nome masculino	a|fer|vo|ra|[men]|to
afervorar	verbo	a|fer|vo|[rar]
afervorável	adjetivo	a|fer|vo|[rá]|vel
afervorizar	verbo	a|fer|vo|ri|[zar]
afestoado	adjetivo	a|fes|to|[a]|do
afestoar	verbo	a|fes|to|[ar]
afestonado	adjetivo	a|fes|to|[na]|do
afestonar	verbo	a|fes|to|[nar]
afetação	nome feminino	a|fe|ta|[ção]
afetada	nome feminino	a|fe|[ta]|da
afetadamente	advérbio	a|fe|ta|da|[men]|te
afetado	adjetivo	a|fe|[ta]|do
afetado	nome masculino	a|fe|[ta]|do
afetador	nome masculino	a|fe|ta|[dor]
afetador	adjetivo	a|fe|ta|[dor]
afetante	adjetivo	a|fe|[tan]|te
afetar	verbo	a|fe|[tar]
afetativo	adjetivo	a|fe|ta|[ti]|vo
afetável	adjetivo	a|fe|[tá]|vel
afetivamente	advérbio	a|fe|ti|va|[men]|te
afetível	adjetivo	a|fe|[tí]|vel
afetividade	nome feminino	a|fe|ti|vi|[da]|de
afetivo	adjetivo	a|fe|[ti]|vo
afetivo	nome masculino	a|fe|[ti]|vo
afeto	adjetivo	a|[fe]|to
afeto	nome masculino	a|[fe]|to
afetuosamente	advérbio	a|fe|tu|o|sa|[men]|te
afetuosidade	nome feminino	a|fe|tu|o|si|[da]|de
afetuoso	adjetivo	a|fe|tu|[o]|so
affair	nome masculino	af|fair
afgani	nome masculino	af|ga|[ni]
afia	nome masculino	a|[fi]|a
afia-lápis	nome masculino	a|fi|a-lá|pis
afiação	nome feminino	a|fi|a|[ção]
afiadeira	nome feminino	a|fi|a|[dei]|ra
afiado	adjetivo	a|fi|[a]|do
afiador	nome masculino	a|fi|a|[dor]
afiador	adjetivo	a|fi|a|[dor]
afiadora	nome feminino	a|fi|a|[do]|ra
afial	nome masculino	a|fi|[al]
afiambrado	adjetivo	a|fi|am|[bra]|do
afiambramento	nome masculino	a|fi|am|bra|[men]|to
afiambrar	verbo	a|fi|am|[brar]
afiamento	nome masculino	a|fi|a|[men]|to
afiançado	nome masculino	a|fi|an|[ça]|do
afiançador	nome masculino	a|fi|an|ça|[dor]
afiançador	adjetivo	a|fi|an|ça|[dor]
afiançadora	nome feminino	a|fi|an|ça|[do]|ra
afiançamento	nome masculino	a|fi|an|ça|[men]|to
afiançar	verbo	a|fi|an|[çar]
afiançável	adjetivo	a|fi|an|[çá]|vel
afiar	verbo	a|fi|[ar]
afiável	adjetivo	a|fi|[á]|vel
aficado	adjetivo	a|fi|[ca]|do
aficador	adjetivo	a|fi|ca|[dor]
aficador	nome masculino	a|fi|ca|[dor]
aficar	verbo	a|fi|[car]
afición	nome feminino	a|fi|ci|[ón]
aficionada	nome feminino	a|fi|ci|o|[na]|da
aficionado	adjetivo	a|fi|ci|o|[na]|do
aficionado	nome masculino	a|fi|ci|o|[na]|do
afidalgadamente	advérbio	a|fi|dal|ga|da|[men]|te
afidalgado	adjetivo	a|fi|dal|[ga]|do
afidalgamento	nome masculino	a|fi|dal|ga|[men]|to
afidalgar	verbo	a|fi|dal|[gar]
afídida	nome masculino	a|[fí]|di|da
afidídeo	nome masculino	a|fi|[dí]|de|o
afidídeo	adjetivo	a|fi|[dí]|de|o
afidídio	nome masculino	a|fi|[dí]|di|o
afídio	nome masculino	a|[fí]|di|o
afifano	nome masculino	a|fi|[fa]|no
afifano	adjetivo	a|fi|[fa]|no
afifar	verbo	a|fi|[far]
afifense	adjetivo	a|fi|[fen]|se
afifense	nome masculino	a|fi|[fen]|se
afifense	nome feminino	a|fi|[fen]|se
afiguração	nome feminino	a|fi|gu|ra|[ção]
afigurador	adjetivo	a|fi|gu|ra|[dor]
afigurador	nome masculino	a|fi|gu|ra|[dor]
afigurar	verbo	a|fi|gu|[rar]
afigurativo	adjetivo	a|fi|gu|ra|[ti]|vo
afigurável	adjetivo	a|fi|gu|[rá]|vel
afilação	nome feminino	a|fi|la|[ção]
afiláctico	adjetivo	a|fi|[lác]|ti|co
afilado	adjetivo	a|fi|[la]|do
afilador	adjetivo	a|fi|la|[dor]
afilador	nome masculino	a|fi|la|[dor]
afiladura	nome feminino	a|fi|la|[du]|ra
afilamento	nome masculino	a|fi|la|[men]|to
afilar	verbo	a|fi|[lar]
afilático	adjetivo	a|fi|[lá]|ti|co
afilaxia	nome feminino	a|fi|la|[xi]|a
afilhação	nome feminino	a|fi|lha|[ção]
afilhada	nome feminino	a|fi|[lha]|da
afilhadagem	nome feminino	a|fi|lha|[da]|gem
afilhadismo	nome masculino	a|fi|lha|[dis]|mo
afilhado	nome masculino	a|fi|[lha]|do
afilhado	adjetivo	a|fi|[lha]|do
afilhamento	nome masculino	a|fi|lha|[men]|to
