afilhar	verbo	a|fi|[lhar]
afiliação	nome feminino	a|fi|li|a|[ção]
afiliar	verbo	a|fi|li|[ar]
afiligranado	adjetivo	a|fi|li|gra|[na]|do
afilo	adjetivo	a|[fi]|lo
afim	adjetivo	a|[fim]
afim	nome masculino	a|[fim]
afim	nome feminino	a|[fim]
afinação	nome feminino	a|fi|na|[ção]
afinadamente	advérbio	a|fi|na|da|[men]|te
afinado	adjetivo	a|fi|[na]|do
afinador	adjetivo	a|fi|na|[dor]
afinador	nome masculino	a|fi|na|[dor]
afinadora	nome feminino	a|fi|na|[do]|ra
afinagem	nome feminino	a|fi|[na]|gem
afinal	advérbio	a|fi|[nal]
afinamento	nome masculino	a|fi|na|[men]|to
afinar	verbo	a|fi|[nar]
afinável	adjetivo	a|fi|[ná]|vel
afincadamente	advérbio	a|fin|ca|da|[men]|te
afincado	adjetivo	a|fin|[ca]|do
afincador	adjetivo	a|fin|ca|[dor]
afincador	nome masculino	a|fin|ca|[dor]
afincamento	nome masculino	a|fin|ca|[men]|to
afincar	verbo	a|fin|[car]
afinco	nome masculino	a|[fin]|co
afincoar	verbo	a|fin|co|[ar]
afinfar	verbo	a|fin|[far]
afinidade	nome feminino	a|fi|ni|[da]|de
áfio	adjetivo	[á]|fi|o
afirmação	nome feminino	a|fir|ma|[ção]
afirmado	adjetivo	a|fir|[ma]|do
afirmador	adjetivo	a|fir|ma|[dor]
afirmador	nome masculino	a|fir|ma|[dor]
afirmante	adjetivo	a|fir|[man]|te
afirmante	nome masculino	a|fir|[man]|te
afirmante	nome feminino	a|fir|[man]|te
afirmar	verbo	a|fir|[mar]
afirmativa	nome feminino	a|fir|ma|[ti]|va
afirmativamente	advérbio	a|fir|ma|ti|va|[men]|te
afirmativo	adjetivo	a|fir|ma|[ti]|vo
afirmável	adjetivo	a|fir|[má]|vel
afistulado	adjetivo	a|fis|tu|[la]|do
afistular	verbo	a|fis|tu|[lar]
afitado	adjetivo	a|fi|[ta]|do
afitamento	nome masculino	a|fi|ta|[men]|to
afitar	verbo	a|fi|[tar]
afito	nome masculino	a|[fi]|to
afítulo	nome masculino	a|[fí]|tu|lo
afiuzar	verbo	a|fiu|[zar]
afivelado	adjetivo	a|fi|ve|[la]|do
afivelar	verbo	a|fi|ve|[lar]
afixação	nome feminino	a|fi|xa|[ção]
afixado	adjetivo	a|fi|[xa]|do
afixador	adjetivo	a|fi|xa|[dor]
afixador	nome masculino	a|fi|xa|[dor]
afixamento	nome masculino	a|fi|xa|[men]|to
afixar	verbo	a|fi|[xar]
afixivo	adjetivo	a|fi|[xi]|vo
afixo	nome masculino	a|[fi]|xo
afixo	adjetivo	a|[fi]|xo
aflamengado	adjetivo	a|fla|men|[ga]|do
aflante	adjetivo	a|[flan]|te
aflar	verbo	a|[flar]
aflato	nome masculino	a|[fla]|to
aflautadamente	advérbio	a|flau|ta|da|[men]|te
aflautado	adjetivo	a|flau|[ta]|do
aflautamento	nome masculino	a|flau|ta|[men]|to
aflautar	verbo	a|flau|[tar]
aflechado	adjetivo	a|fle|[cha]|do
aflechar	verbo	a|fle|[char]
afleimar	verbo	a|flei|[mar]
afleumar	verbo	a|fleu|[mar]
aflição	nome feminino	a|fli|[ção]
afligente	adjetivo	a|fli|[gen]|te
afligido	adjetivo	a|fli|[gi]|do
afligido	nome masculino	a|fli|[gi]|do
afligidor	adjetivo	a|fli|gi|[dor]
afligidor	nome masculino	a|fli|gi|[dor]
afligimento	nome masculino	a|fli|gi|[men]|to
afligir	verbo	a|fli|[gir]
afligível	adjetivo	a|fli|[gí]|vel
aflita	nome feminino	a|[fli]|ta
aflitamente	advérbio	a|fli|ta|[men]|te
aflitivamente	advérbio	a|fli|ti|va|[men]|te
aflitivo	adjetivo	a|fli|[ti]|vo
aflito	nome masculino	a|[fli]|to
aflito	adjetivo	a|[fli]|to
aflogístico	adjetivo	a|flo|[gís]|ti|co
afloração	nome feminino	a|flo|ra|[ção]
afloramento	nome masculino	a|flo|ra|[men]|to
aflorar	verbo	a|flo|[rar]
aflouxar	verbo	a|flou|[xar]
afluência	nome feminino	a|flu|[ên]|ci|a
afluente	nome masculino	a|flu|[en]|te
afluente	adjetivo	a|flu|[en]|te
afluir	verbo	a|flu|[ir]
afluxo	nome masculino	a|[flu]|xo
afobação	nome feminino	a|fo|ba|[ção]
afobado	adjetivo	a|fo|[ba]|do
