água-forte	nome feminino	á|gua-for|te
água-fortista	adjetivo	á|gua-for|[tis]|ta
água-fortista	nome masculino	á|gua-for|[tis]|ta
água-fortista	nome feminino	á|gua-for|[tis]|ta
água-mãe	nome feminino	á|gua-mãe
água-marinha	nome feminino	á|gua-ma|[ri]|nha
água-mato	nome feminino	á|gua-ma|to
água-mel	nome feminino	á|gua-mel
água-oxigenada	nome feminino	á|gua-o|xi|ge|[na]|da
água-pé	nome feminino	á|gua-pé
água-pedrense	nome feminino	á|gua-pe|[dren]|se
água-pedrense	adjetivo	á|gua-pe|[dren]|se
água-pedrense	nome masculino	á|gua-pe|[dren]|se
água-ruça	nome feminino	á|gua-ru|ça
água-tinta	nome feminino	á|gua-tin|ta
água-viva	nome feminino	á|gua-vi|va
aguabresa	nome feminino	a|gua|[bre]|sa
aguaça	nome feminino	a|[gua]|ça
aguaçado	adjetivo	a|gua|[ça]|do
aguaçal	nome masculino	a|gua|[çal]
aguacate	nome masculino	a|gua|[ca]|te
aguaceira	nome feminino	a|gua|[cei]|ra
aguaceirada	nome feminino	a|gua|cei|[ra]|da
aguaceiro	nome masculino	a|gua|[cei]|ro
aguacento	adjetivo	a|gua|[cen]|to
aguachado	adjetivo	a|gua|[cha]|do
aguachado	nome masculino	a|gua|[cha]|do
aguada	nome feminino	a|[gua]|da
aguadeira	nome feminino	a|gua|[dei]|ra
aguadeiras	nome feminino	a|gua|[dei]|ras
aguadeiro	nome masculino	a|gua|[dei]|ro
aguadilha	nome feminino	a|gua|[di]|lha
aguado	adjetivo	a|[gua]|do
aguador	nome masculino	a|gua|[dor]
aguadouro	nome masculino	a|gua|[dou]|ro
aguadura	nome feminino	a|gua|[du]|ra
aguagem	nome feminino	a|[gua]|gem
aguai	nome masculino	a|[guai]
aguaiana	nome feminino	a|gua|i|[a]|na
aguaiano	nome masculino	a|gua|i|[a]|no
aguaiano	adjetivo	a|gua|i|[a]|no
aguaiense	nome feminino	a|gua|i|[en]|se
aguaiense	adjetivo	a|gua|i|[en]|se
aguaiense	nome masculino	a|gua|i|[en]|se
aguamento	nome masculino	a|gua|[men]|to
aguantar	verbo	a|guan|[tar]
aguante	nome masculino	a|[guan]|te
aguapá	nome feminino	a|gua|[pá]
aguapé	nome masculino	a|gua|[pé]
aguapezal	nome masculino	a|gua|pe|[zal]
aguar	verbo	a|[guar]
aguardador	nome masculino	a|guar|da|[dor]
aguardamento	nome masculino	a|guar|da|[men]|to
aguardante	adjetivo	a|guar|[dan]|te
aguardante	nome masculino	a|guar|[dan]|te
aguardante	nome feminino	a|guar|[dan]|te
aguardar	verbo	a|guar|[dar]
aguardentação	nome feminino	a|guar|den|ta|[ção]
aguardentão	adjetivo	a|guar|den|[tão]
aguardentar	verbo	a|guar|den|[tar]
aguardentaria	nome feminino	a|guar|den|ta|[ri]|a
aguardente	nome feminino	a|guar|[den]|te
aguardenteiro	nome masculino	a|guar|den|[tei]|ro
aguardentia	nome feminino	a|guar|den|[ti]|a
aguardentoso	adjetivo	a|guar|den|[to]|so
aguardo	nome masculino	a|[guar]|do
aguareira	nome feminino	a|gua|[rei]|ra
aguarela	nome feminino	a|gua|[re]|la
aguarelado	adjetivo	a|gua|re|[la]|do
aguarelar	verbo	a|gua|re|[lar]
aguarelista	nome masculino	a|gua|re|[lis]|ta
aguarelista	nome feminino	a|gua|re|[lis]|ta
aguarentador	nome masculino	a|gua|ren|ta|[dor]
aguarentar	verbo	a|gua|ren|[tar]
aguariço	nome masculino	a|gua|[ri]|ço
aguaritar	verbo	a|gua|ri|[tar]
aguarrada	nome feminino	a|guar|[ra]|da
aguarrado	adjetivo	a|guar|[ra]|do
aguarrás	nome feminino	a|guar|[rás]
águas-furtadas	nome feminino	á|guas-fur|[ta]|das
aguazil	nome masculino	a|gua|[zil]
aguça	nome masculino	a|[gu]|ça
aguça	nome feminino	a|[gu]|ça
aguçadamente	advérbio	a|gu|ça|da|[men]|te
aguçadeira	nome feminino	a|gu|ça|[dei]|ra
aguçado	adjetivo	a|gu|[ça]|do
aguçadoira	nome feminino	a|gu|ça|[doi]|ra
aguçador	nome masculino	a|gu|ça|[dor]
aguçador	adjetivo	a|gu|ça|[dor]
aguçadoura	nome feminino	a|gu|ça|[dou]|ra
aguçadura	nome feminino	a|gu|ça|[du]|ra
aguçamento	nome masculino	a|gu|ça|[men]|to
aguçar	verbo	a|gu|[çar]
aguçável	adjetivo	a|gu|[çá]|vel
aguço	nome masculino	a|[gu]|ço
aguçosamente	advérbio	a|gu|ço|sa|[men]|te
aguçoso	adjetivo	a|gu|[ço]|so
aguda	nome feminino	a|[gu]|da
agudamente	advérbio	a|gu|da|[men]|te
agude	nome feminino	a|[gu]|de
