inconstitucionalmente	advérbio	in|cons|ti|tu|ci|o|nal|[men]|te
inconstituível	adjetivo	in|cons|ti|tu|[í]|vel
inconsultável	adjetivo	in|con|sul|[tá]|vel
inconsulto	adjetivo	in|con|[sul]|to
inconsumível	adjetivo	in|con|su|[mí]|vel
inconsumptibilidade	nome feminino	in|con|sump|ti|bi|li|[da]|de
inconsumptível	adjetivo	in|con|sump|[tí]|vel
inconsumpto	adjetivo	in|con|[sump]|to
inconsuntibilidade	nome feminino	in|con|sun|ti|bi|li|[da]|de
inconsunto	adjetivo	in|con|[sun]|to
inconsútil	adjetivo	in|con|[sú]|til
incontactável	adjetivo	in|con|tac|[tá]|vel
incontaminado	adjetivo	in|con|ta|mi|[na]|do
incontaminável	adjetivo	in|con|ta|mi|[ná]|vel
incontatável	adjetivo	in|con|ta|[tá]|vel
incontável	adjetivo	in|con|[tá]|vel
incontavelmente	advérbio	in|con|ta|vel|[men]|te
incontemplativo	adjetivo	in|con|tem|pla|[ti]|vo
incontendível	adjetivo	in|con|ten|[dí]|vel
incontentável	adjetivo	in|con|ten|[tá]|vel
incontestabilidade	nome feminino	in|con|tes|ta|bi|li|[da]|de
incontestado	adjetivo	in|con|tes|[ta]|do
incontestável	adjetivo	in|con|tes|[tá]|vel
incontestavelmente	advérbio	in|con|tes|ta|vel|[men]|te
inconteste	adjetivo	in|con|[tes]|te
incontido	adjetivo	in|con|[ti]|do
incontinência	nome feminino	in|con|ti|[nên]|ci|a
incontinente	nome masculino	in|con|ti|[nen]|te
incontinente	adjetivo	in|con|ti|[nen]|te
incontinente	nome feminino	in|con|ti|[nen]|te
incontinentemente	advérbio	in|con|ti|nen|te|[men]|te
incontingência	nome feminino	in|con|tin|[gên]|ci|a
incontingente	adjetivo	in|con|tin|[gen]|te
incontinuidade	nome feminino	in|con|ti|nu|i|[da]|de
incontínuo	adjetivo	in|con|[tí]|nu|o
incontornabilidade	nome feminino	in|con|tor|na|bi|li|[da]|de
incontornável	adjetivo	in|con|tor|[ná]|vel
incontrariável	adjetivo	in|con|tra|ri|[á]|vel
incontrastado	adjetivo	in|con|tras|[ta]|do
incontrastável	adjetivo	in|con|tras|[tá]|vel
incontrastavelmente	advérbio	in|con|tras|ta|vel|[men]|te
incontrito	adjetivo	in|con|[tri]|to
incontrolabilidade	nome feminino	in|con|tro|la|bi|li|[da]|de
incontrolado	adjetivo	in|con|tro|[la]|do
incontrolável	adjetivo	in|con|tro|[lá]|vel
incontroverso	adjetivo	in|con|tro|[ver]|so
incontrovertido	adjetivo	in|con|tro|ver|[ti]|do
incontrovertível	adjetivo	in|con|tro|ver|[tí]|vel
inconveniência	nome feminino	in|con|ve|ni|[ên]|ci|a
inconveniente	nome masculino	in|con|ve|ni|[en]|te
inconveniente	adjetivo	in|con|ve|ni|[en]|te
inconveniente	nome feminino	in|con|ve|ni|[en]|te
inconvenientemente	advérbio	in|con|ve|ni|en|te|[men]|te
inconversável	adjetivo	in|con|ver|[sá]|vel
inconversibilidade	nome feminino	in|con|ver|si|bi|li|[da]|de
inconversível	adjetivo	in|con|ver|[sí]|vel
inconverso	adjetivo	in|con|[ver]|so
inconvertibilidade	nome feminino	in|con|ver|ti|bi|li|[da]|de
inconvertido	adjetivo	in|con|ver|[ti]|do
inconvertível	adjetivo	in|con|ver|[tí]|vel
inconvicção	nome feminino	in|con|vic|[ção]
inconvicto	adjetivo	in|con|[vic]|to
inconvulso	adjetivo	in|con|[vul]|so
incoordenação	nome feminino	in|co|or|de|na|[ção]
incoordenado	adjetivo	in|co|or|de|[na]|do
incorporação	nome feminino	in|cor|po|ra|[ção]
incorporado	adjetivo	in|cor|po|[ra]|do
incorporador	adjetivo	in|cor|po|ra|[dor]
incorporador	nome masculino	in|cor|po|ra|[dor]
incorporal	adjetivo	in|cor|po|[ral]
incorporalidade	nome feminino	in|cor|po|ra|li|[da]|de
incorporante	adjetivo	in|cor|po|[ran]|te
incorporar	verbo	in|cor|po|[rar]
incorporativo	adjetivo	in|cor|po|ra|[ti]|vo
incorporável	adjetivo	in|cor|po|[rá]|vel
incorporeamente	advérbio	in|cor|po|re|a|[men]|te
incorporeidade	nome feminino	in|cor|po|rei|[da]|de
incorpóreo	adjetivo	in|cor|[pó]|re|o
incorreção	nome feminino	in|cor|re|[ção]
incorrer	verbo	in|cor|[rer]
incorrespondido	adjetivo	in|cor|res|pon|[di]|do
incorretamente	advérbio	in|cor|re|ta|[men]|te
incorreto	adjetivo	in|cor|[re]|to
incorrigibilidade	nome feminino	in|cor|ri|gi|bi|li|[da]|de
incorrigível	adjetivo	in|cor|ri|[gí]|vel
incorrigível	nome feminino	in|cor|ri|[gí]|vel
incorrigível	nome masculino	in|cor|ri|[gí]|vel
incorrigivelmente	advérbio	in|cor|ri|gi|vel|[men]|te
incorrimento	nome masculino	in|cor|ri|[men]|to
incorrosível	adjetivo	in|cor|ro|[sí]|vel
incorrupção	nome feminino	in|cor|rup|[ção]
incorruptamente	advérbio	in|cor|rup|ta|[men]|te
incorruptibilidade	nome feminino	in|cor|rup|ti|bi|li|[da]|de
incorruptível	adjetivo	in|cor|rup|[tí]|vel
incorruptível	nome masculino	in|cor|rup|[tí]|vel
incorruptível	nome feminino	in|cor|rup|[tí]|vel
incorruptivelmente	advérbio	in|cor|rup|ti|vel|[men]|te
incorruptivo	adjetivo	in|cor|rup|[ti]|vo
incorrupto	adjetivo	in|cor|[rup]|to
incorrutibilidade	nome feminino	in|cor|ru|ti|bi|li|[da]|de
