influenciar	verbo	in|flu|en|ci|[ar]
influenciável	adjetivo	in|flu|en|ci|[á]|vel
influente	nome masculino	in|flu|[en]|te
influente	adjetivo	in|flu|[en]|te
influente	nome feminino	in|flu|[en]|te
influentemente	advérbio	in|flu|en|te|[men]|te
influenza	nome feminino	in|flu|[en]|za
influição	nome feminino	in|flu|i|[ção]
influído	adjetivo	in|flu|[í]|do
influidor	adjetivo	in|flu|i|[dor]
influidor	nome masculino	in|flu|i|[dor]
influidora	nome feminino	in|flu|i|[do]|ra
influir	verbo	in|flu|[ir]
influxado	adjetivo	in|flu|[xa]|do
influxo	nome masculino	in|[flu]|xo
infoalfabetização	nome feminino	in|fo|al|fa|be|ti|za|[ção]
infoexcluído	adjetivo	in|fo|ex|clu|[í]|do
infoexcluído	nome masculino	in|fo|ex|clu|[í]|do
infoexclusão	nome feminino	in|fo|ex|clu|[são]
infografia	nome feminino	in|fo|gra|[fi]|a
infográfico	nome masculino	in|fo|[grá]|fi|co
infográfico	adjetivo	in|fo|[grá]|fi|co
infografista	nome masculino	in|fo|gra|[fis]|ta
infografista	nome feminino	in|fo|gra|[fis]|ta
infólio	adjetivo	in|[fó]|li|o
infólio	nome masculino	in|[fó]|li|o
infonauta	nome masculino	in|fo|[nau]|ta
infonauta	nome feminino	in|fo|[nau]|ta
informação	nome feminino	in|for|ma|[ção]
informacional	adjetivo	in|for|ma|ci|o|[nal]
informado	adjetivo	in|for|[ma]|do
informador	adjetivo	in|for|ma|[dor]
informador	nome masculino	in|for|ma|[dor]
informadora	nome feminino	in|for|ma|[do]|ra
informal	adjetivo	in|for|[mal]
informalidade	nome feminino	in|for|ma|li|[da]|de
informalismo	nome masculino	in|for|ma|[lis]|mo
informalmente	advérbio	in|for|mal|[men]|te
informante	adjetivo	in|for|[man]|te
informante	nome masculino	in|for|[man]|te
informante	nome feminino	in|for|[man]|te
informar	verbo	in|for|[mar]
informática	nome feminino	in|for|[má]|ti|ca
informaticamente	advérbio	in|for|ma|ti|ca|[men]|te
informático	nome masculino	in|for|[má]|ti|co
informático	adjetivo	in|for|[má]|ti|co
informativamente	advérbio	in|for|ma|ti|va|[men]|te
informativo	adjetivo	in|for|ma|[ti]|vo
informatização	nome feminino	in|for|ma|ti|za|[ção]
informatizado	adjetivo	in|for|ma|ti|[za]|do
informatizar	verbo	in|for|ma|ti|[zar]
informatizável	adjetivo	in|for|ma|ti|[zá]|vel
informável	adjetivo	in|for|[má]|vel
informe	adjetivo	in|[for]|me
informe	nome masculino	in|[for]|me
informemente	advérbio	in|for|me|[men]|te
informidade	nome feminino	in|for|mi|[da]|de
informulável	adjetivo	in|for|mu|[lá]|vel
infortificável	adjetivo	in|for|ti|fi|[cá]|vel
infortuna	nome feminino	in|for|[tu]|na
infortunada	nome feminino	in|for|tu|[na]|da
infortunadamente	advérbio	in|for|tu|na|da|[men]|te
infortunado	adjetivo	in|for|tu|[na]|do
infortunado	nome masculino	in|for|tu|[na]|do
infortunar	verbo	in|for|tu|[nar]
infortunidade	nome feminino	in|for|tu|ni|[da]|de
infortúnio	nome masculino	in|for|[tú]|ni|o
infortunoso	adjetivo	in|for|tu|[no]|so
infotainment	nome masculino	in|fo|tain|ment
infra	advérbio	[in]|fra
infra-assinado	adjetivo	in|fra-as|si|[na]|do
infra-assinado	nome masculino	in|fra-as|si|[na]|do
infra-axilar	adjetivo	in|fra-a|xi|[lar]
infra-hepático	adjetivo	in|fra-he|[pá]|ti|co
infra-homem	nome masculino	in|fra-ho|mem
infra-humano	nome masculino	in|fra-hu|[ma]|no
infração	nome feminino	in|fra|[ção]
infracção	nome feminino	in|frac|[ção]
infracitado	adjetivo	in|fra|ci|[ta]|do
infracomum	adjetivo	in|fra|co|[mum]
infracretáceo	adjetivo	in|fra|cre|[tá]|ce|o
infracto	adjetivo	in|[frac]|to
infractor	adjetivo	in|frac|[tor]
infractor	nome masculino	in|frac|[tor]
infractora	nome feminino	in|frac|[to]|ra
infraescapular	adjetivo	in|fraes|ca|pu|[lar]
infraescavação	nome feminino	in|fraes|ca|va|[ção]
infraescrito	adjetivo	in|fra|es|[cri]|to
infraestrutura	nome feminino	in|fra|es|tru|[tu]|ra
infraestruturação	nome feminino	in|fra|es|tru|tu|ra|[ção]
infraestruturado	adjetivo	in|fra|es|tru|tu|[ra]|do
infraestrutural	adjetivo	in|fra|es|tru|tu|[ral]
infraglótico	adjetivo	in|fra|[gló]|ti|co
infragmentável	adjetivo	in|frag|men|[tá]|vel
infrajurássico	adjetivo	in|fra|ju|[rás]|si|co
infralapsário	adjetivo	in|fra|lap|[sá]|ri|o
infralapsário	nome masculino	in|fra|lap|[sá]|ri|o
infralapsarismo	nome masculino	in|fra|lap|sa|[ris]|mo
infralativo	adjetivo	in|fra|la|[ti]|vo
infralativo	nome masculino	in|fra|la|[ti]|vo
