inteiro	nome masculino	in|[tei]|ro
inteleção	nome feminino	in|te|le|[ção]
intelecção	nome feminino	in|te|lec|[ção]
intelectivamente	advérbio	in|te|lec|ti|va|[men]|te
intelectível	adjetivo	in|te|lec|[tí]|vel
intelectivo	adjetivo	in|te|lec|[ti]|vo
intelecto	nome masculino	in|te|[lec]|to
intelectual	adjetivo	in|te|lec|tu|[al]
intelectual	nome masculino	in|te|lec|tu|[al]
intelectual	nome feminino	in|te|lec|tu|[al]
intelectualidade	nome feminino	in|te|lec|tu|a|li|[da]|de
intelectualismo	nome masculino	in|te|lec|tu|a|[lis]|mo
intelectualista	adjetivo	in|te|lec|tu|a|[lis]|ta
intelectualista	nome masculino	in|te|lec|tu|a|[lis]|ta
intelectualista	nome feminino	in|te|lec|tu|a|[lis]|ta
intelectualização	nome feminino	in|te|lec|tu|a|li|za|[ção]
intelectualizado	adjetivo	in|te|lec|tu|a|li|[za]|do
intelectualizador	adjetivo	in|te|lec|tu|a|li|za|[dor]
intelectualizar	verbo	in|te|lec|tu|a|li|[zar]
intelectualizável	adjetivo	in|te|lec|tu|a|li|[zá]|vel
intelectualmente	advérbio	in|te|lec|tu|al|[men]|te
inteligência	nome feminino	in|te|li|[gên]|ci|a
inteligente	adjetivo	in|te|li|[gen]|te
inteligente	nome masculino	in|te|li|[gen]|te
inteligentemente	advérbio	in|te|li|gen|te|[men]|te
inteligibilidade	nome feminino	in|te|li|gi|bi|li|[da]|de
inteligível	adjetivo	in|te|li|[gí]|vel
inteligível	nome masculino	in|te|li|[gí]|vel
inteligivelmente	advérbio	in|te|li|gi|vel|[men]|te
intelligentsia	nome feminino	in|tel|li|gent|si|a
intelligentzia	nome feminino	in|tel|li|gent|zi|a
intemélio	adjetivo	in|te|[mé]|li|o
intemélio	nome masculino	in|te|[mé]|li|o
intemente	adjetivo	in|te|[men]|te
intemeratamente	advérbio	in|te|me|ra|ta|[men]|te
intemerato	adjetivo	in|te|me|[ra]|to
intemperadamente	advérbio	in|tem|pe|ra|da|[men]|te
intemperado	adjetivo	in|tem|pe|[ra]|do
intemperamento	nome masculino	in|tem|pe|ra|[men]|to
intemperança	nome feminino	in|tem|pe|[ran]|ça
intemperante	adjetivo	in|tem|pe|[ran]|te
intemperar	verbo	in|tem|pe|[rar]
intempérico	adjetivo	in|tem|[pé]|ri|co
intempérie	nome feminino	in|tem|[pé]|ri|e
intemperismo	nome masculino	in|tem|pe|[ris]|mo
intempestivamente	advérbio	in|tem|pes|ti|va|[men]|te
intempestividade	nome feminino	in|tem|pes|ti|vi|[da]|de
intempestivo	adjetivo	in|tem|pes|[ti]|vo
intemporal	adjetivo	in|tem|po|[ral]
intemporalidade	nome feminino	in|tem|po|ra|li|[da]|de
intemporalmente	advérbio	in|tem|po|ral|[men]|te
intenção	nome feminino	in|ten|[ção]
intencionado	adjetivo	in|ten|ci|o|[na]|do
intencional	adjetivo	in|ten|ci|o|[nal]
intencionalidade	nome feminino	in|ten|ci|o|na|li|[da]|de
intencionalismo	nome masculino	in|ten|ci|o|na|[lis]|mo
intencionalmente	advérbio	in|ten|ci|o|nal|[men]|te
intencionar	verbo	in|ten|ci|o|[nar]
intencionável	adjetivo	in|ten|ci|o|[ná]|vel
intencionismo	nome masculino	in|ten|ci|o|[nis]|mo
intencionista	nome masculino	in|ten|ci|o|[nis]|ta
intencionista	adjetivo	in|ten|ci|o|[nis]|ta
intencionista	nome feminino	in|ten|ci|o|[nis]|ta
intendência	nome feminino	in|ten|[dên]|ci|a
intendência-geral	nome feminino	in|ten|dên|ci|a-ge|ral
intendente	nome masculino	in|ten|[den]|te
intendente-geral	nome masculino	in|ten|den|te-ge|[ral]
intender	verbo	in|ten|[der]
intensamente	advérbio	in|ten|sa|[men]|te
intensão	nome feminino	in|ten|[são]
intensar	verbo	in|ten|[sar]
intensidade	nome feminino	in|ten|si|[da]|de
intensificação	nome feminino	in|ten|si|fi|ca|[ção]
intensificador	adjetivo	in|ten|si|fi|ca|[dor]
intensificador	nome masculino	in|ten|si|fi|ca|[dor]
intensificar	verbo	in|ten|si|fi|[car]
intensificável	adjetivo	in|ten|si|fi|[cá]|vel
intensivamente	advérbio	in|ten|si|va|[men]|te
intensivo	adjetivo	in|ten|[si]|vo
intenso	adjetivo	in|[ten]|so
intentado	adjetivo	in|ten|[ta]|do
intentar	verbo	in|ten|[tar]
intentável	adjetivo	in|ten|[tá]|vel
intento	nome masculino	in|[ten]|to
intentona	nome feminino	in|ten|[to]|na
inter-helênico	adjetivo	in|ter-he|[lê]|ni|co
inter-helénico	adjetivo	in|ter-he|[lé]|ni|co
inter-humano	adjetivo	in|ter-hu|[ma]|no
inter-racial	adjetivo	in|ter-ra|ci|[al]
inter-radial	adjetivo	in|ter-ra|di|[al]
inter-regional	adjetivo	in|ter-re|gi|o|[nal]
inter-rei	nome masculino	in|ter-rei
inter-relação	nome feminino	in|ter-re|la|[ção]
inter-relacionado	adjetivo	in|ter-re|la|ci|o|[na]|do
inter-relacionamento	nome masculino	in|ter-re|la|ci|o|na|[men]|to
inter-relacionar	verbo	in|ter-re|la|ci|o|[nar]
inter-relativo	adjetivo	in|ter-re|la|[ti]|vo
inter-religioso	adjetivo	in|ter-re|li|gi|[o]|so
inter-resistente	adjetivo	in|ter-re|sis|[ten]|te
interacadémico	adjetivo	in|te|ra|ca|[dé]|mi|co
