cleoneu	nome masculino	cle|o|[neu]
cleónia	nome feminino	cle|[ó]|ni|a
cleônia	nome feminino	cle|[ô]|ni|a
cleopatrino	adjetivo	cle|o|pa|[tri]|no
cleopatrizar	verbo	cle|o|pa|tri|[zar]
clepsidra	nome feminino	clep|[si]|dra
cleptocracia	nome feminino	clep|to|cra|[ci]|a
cleptocrata	adjetivo	clep|to|[cra]|ta
cleptocrata	nome masculino	clep|to|[cra]|ta
cleptocrata	nome feminino	clep|to|[cra]|ta
cleptocrático	adjetivo	clep|to|[crá]|ti|co
cleptófoba	nome feminino	clep|[tó]|fo|ba
cleptofobia	nome feminino	clep|to|fo|[bi]|a
cleptófobo	nome masculino	clep|[tó]|fo|bo
cleptófobo	adjetivo	clep|[tó]|fo|bo
cleptómana	nome feminino	clep|[tó]|ma|na
cleptomania	nome feminino	clep|to|ma|[ni]|a
cleptomaníaca	nome feminino	clep|to|ma|[ní]|a|ca
cleptomaníaco	adjetivo	clep|to|ma|[ní]|a|co
cleptomaníaco	nome masculino	clep|to|ma|[ní]|a|co
cleptômano	adjetivo	clep|[tô]|ma|no
cleptômano	nome masculino	clep|[tô]|ma|no
cleptómano	adjetivo	clep|[tó]|ma|no
cleptómano	nome masculino	clep|[tó]|ma|no
clerestório	nome masculino	cle|res|[tó]|ri|o
clerezia	nome feminino	cle|re|[zi]|a
clerical	adjetivo	cle|ri|[cal]
clerical	nome masculino	cle|ri|[cal]
clericalismo	nome masculino	cle|ri|ca|[lis]|mo
clericalista	nome masculino	cle|ri|ca|[lis]|ta
clericalista	nome feminino	cle|ri|ca|[lis]|ta
clericalista	adjetivo	cle|ri|ca|[lis]|ta
clericalístico	adjetivo	cle|ri|ca|[lís]|ti|co
clericalização	nome feminino	cle|ri|ca|li|za|[ção]
clericalizar	verbo	cle|ri|ca|li|[zar]
clericalmente	advérbio	cle|ri|cal|[men]|te
clericato	nome masculino	cle|ri|[ca]|to
clérigo	nome masculino	[clé]|ri|go
clero	nome masculino	[cle]|ro
clerocracia	nome feminino	cle|ro|cra|[ci]|a
clerodendro	nome masculino	cle|ro|[den]|dro
clerofobia	nome feminino	cle|ro|fo|[bi]|a
clerófobo	adjetivo	cle|[ró]|fo|bo
clerófobo	nome masculino	cle|[ró]|fo|bo
cleromancia	nome feminino	cle|ro|man|[ci]|a
cleromante	nome masculino	cle|ro|[man]|te
cleromante	nome feminino	cle|ro|[man]|te
cleromântico	adjetivo	cle|ro|[mân]|ti|co
cleruco	nome masculino	cle|[ru]|co
cleruquia	nome feminino	cle|ru|[qui]|a
cletra	nome feminino	[cle]|tra
cleveíte	nome feminino	cle|ve|[í]|te
clevelandês	adjetivo	cle|ve|lan|[dês]
clevelandês	nome masculino	cle|ve|lan|[dês]
clicar	verbo	cli|[car]
clicável	adjetivo	cli|[cá]|vel
cliché	nome masculino	cli|[ché]
clichê	nome masculino	cli|[chê]
clícia	nome feminino	[clí]|ci|a
clidocostal	adjetivo	cli|do|cos|[tal]
clidomamário	adjetivo	cli|do|ma|[má]|ri|o
clidomancia	nome feminino	cli|do|man|[ci]|a
clidomante	nome masculino	cli|do|[man]|te
clidomante	nome feminino	cli|do|[man]|te
clidomântico	adjetivo	cli|do|[mân]|ti|co
clidonógrafo	nome masculino	cli|do|[nó]|gra|fo
clidorréctico	adjetivo	cli|dor|[réc]|ti|co
clidorrético	adjetivo	cli|dor|[ré]|ti|co
clidorrexia	nome feminino	cli|dor|re|[xi]|a
clidoscopia	nome feminino	cli|dos|co|[pi]|a
clidoscópico	adjetivo	cli|dos|[có]|pi|co
clidotomia	nome feminino	cli|do|to|[mi]|a
clidotômico	adjetivo	cli|do|[tô]|mi|co
clidotómico	adjetivo	cli|do|[tó]|mi|co
cliente	nome masculino	cli|[en]|te
cliente	nome feminino	cli|[en]|te
cliente-tipo	nome masculino	cli|en|te-ti|po
clientela	nome feminino	cli|en|[te]|la
clientelar	adjetivo	cli|en|te|[lar]
clientelismo	nome masculino	cli|en|te|[lis]|mo
clientelista	adjetivo	cli|en|te|[lis]|ta
clientelista	nome masculino	cli|en|te|[lis]|ta
clientelista	nome feminino	cli|en|te|[lis]|ta
clientelístico	adjetivo	cli|en|te|[lís]|ti|co
clima	nome masculino	[cli]|ma
clímace	nome feminino	[clí]|ma|ce
climactérico	adjetivo	cli|mac|[té]|ri|co
climactério	nome masculino	cli|mac|[té]|ri|o
climáctico	adjetivo	cli|[mác]|ti|co
climatérico	adjetivo	cli|ma|[té]|ri|co
climatério	nome masculino	cli|ma|[té]|ri|o
climaticamente	advérbio	cli|ma|ti|ca|[men]|te
climático	adjetivo	cli|[má]|ti|co
climatismo	nome masculino	cli|ma|[tis]|mo
climatização	nome feminino	cli|ma|ti|za|[ção]
climatizado	adjetivo	cli|ma|ti|[za]|do
climatizador	nome masculino	cli|ma|ti|za|[dor]
climatizar	verbo	cli|ma|ti|[zar]
climatologia	nome feminino	cli|ma|to|lo|[gi]|a
climatológico	adjetivo	cli|ma|to|[ló]|gi|co
