cuche	interjeição	[cu]|che
cuchê	adjetivo	cu|[chê]
cuche-cuche	interjeição	cu|che-cu|che
cuchete	nome feminino	cu|[che]|te
cuchilha	nome feminino	cu|[chi]|lha
cuchilho	nome masculino	cu|[chi]|lho
cuci	nome masculino	cu|[ci]
cuciófera	nome feminino	cu|ci|[ó]|fe|ra
cuco	nome masculino	[cu]|co
cucuiada	nome feminino	cu|cui|[a]|da
cucular	verbo	cu|cu|[lar]
cucúlida	nome masculino	cu|[cú]|li|da
cucúlida	nome masculino	cu|[cú]|li|da
cuculídeo	nome masculino	cu|cu|[lí]|de|o
cuculídeo	nome masculino	cu|cu|[lí]|de|o
cuculídeo	adjetivo	cu|cu|[lí]|de|o
cuculífero	adjetivo	cu|cu|[lí]|fe|ro
cuculifólio	adjetivo	cu|cu|li|[fó]|li|o
cuculiforme	adjetivo	cu|cu|li|[for]|me
cuculo	nome masculino	cu|[cu]|lo
cucumela	nome feminino	cu|cu|[me]|la
cucumiforme	adjetivo	cu|cu|mi|[for]|me
cucúrbita	nome feminino	cu|[cúr]|bi|ta
cucurbitácea	nome feminino	cu|cur|bi|[tá]|ce|a
cucurbitáceo	adjetivo	cu|cur|bi|[tá]|ce|o
cucurbitar	verbo	cu|cur|bi|[tar]
cucurbitina	nome feminino	cu|cur|bi|[ti]|na
cucurbitino	adjetivo	cu|cur|bi|[ti]|no
cucuricar	verbo	cu|cu|ri|[car]
cucuritar	verbo	cu|cu|ri|[tar]
cucuru	nome masculino	cu|cu|[ru]
cucurucu	nome masculino	cu|cu|ru|[cu]
cucurucu	interjeição	cu|cu|ru|[cu]
cudar	verbo	cu|[dar]
cudo	nome masculino	[cu]|do
cueca	nome feminino	cu|[e]|ca
cuecas	nome feminino	cu|[e]|cas
cuedano	nome masculino	cu|e|[da]|no
cueiro	nome masculino	cu|[ei]|ro
cuele	nome masculino	cu|[e]|le
cuera	nome feminino	cu|[e]|ra
cuerudo	adjetivo	cu|e|[ru]|do
cufala	nome feminino	cu|[fa]|la
cúfico	adjetivo	[cú]|fi|co
cufólito	nome masculino	cu|[fó]|li|to
cugerno	adjetivo	cu|[ger]|no
cugerno	nome masculino	cu|[ger]|no
cuguar	nome masculino	cu|[guar]
cuguardo	nome masculino	cu|[guar]|do
cuí	nome masculino	cu|[í]
cuia	nome feminino	[cui]|a
cuiabá	adjetivo	cui|a|[bá]
cuiabá	nome masculino	cui|a|[bá]
cuiabá	nome feminino	cui|a|[bá]
cuiabana	nome feminino	cui|a|[ba]|na
cuiabano	adjetivo	cui|a|[ba]|no
cuiabano	nome masculino	cui|a|[ba]|no
cuiada	nome feminino	cui|[a]|da
cuiambuca	nome feminino	cui|am|[bu]|ca
cuibaba	nome feminino	cui|[ba]|ba
cuibana	nome feminino	cui|[ba]|na
cuibano	nome masculino	cui|[ba]|no
cuibano	adjetivo	cui|[ba]|no
cuíca	nome feminino	cu|[í]|ca
cuidadeira	nome feminino	cui|da|[dei]|ra
cuidado	adjetivo	cui|[da]|do
cuidado	nome masculino	cui|[da]|do
cuidado	interjeição	cui|[da]|do
cuidador	adjetivo	cui|da|[dor]
cuidador	nome masculino	cui|da|[dor]
cuidadosamente	advérbio	cui|da|do|sa|[men]|te
cuidadoso	adjetivo	cui|da|[do]|so
cuidança	nome feminino	cui|[dan]|ça
cuidar	verbo	cui|[dar]
cuidaru	nome feminino	cui|da|[ru]
cuidável	adjetivo	cui|[dá]|vel
cuido	nome masculino	[cui]|do
cuidoso	adjetivo	cui|[do]|so
cuieira	nome feminino	cui|[ei]|ra
cuilar	verbo	cui|[lar]
cuim	nome masculino	cu|[im]
cuincar	verbo	cu|in|[car]
cuinchar	verbo	cu|in|[char]
cuinha	nome feminino	cu|[i]|nha
cuinhar	verbo	cu|i|[nhar]
cuinhira	nome feminino	cu|i|[nhi]|ra
cuisiano	adjetivo	cui|si|[a]|no
cuité	nome feminino	cui|[té]
cuitê	nome feminino	cui|[tê]
cuité	nome masculino	cui|[té]
cuité-acu	nome masculino	cui|té-a|[cu]
cuitezeira	nome feminino	cui|te|[zei]|ra
cuiú	nome masculino	cui|[ú]
cuiú-cuiú	nome masculino	cui|ú-cui|[ú]
cuiuba	nome feminino	cui|[u]|ba
cujo	artigo relativo	[cu]|jo
cujuba	nome feminino	cu|[ju]|ba
cujubeira	nome feminino	cu|ju|[bei]|ra
cujubi	nome masculino	cu|ju|[bi]
cujubiboia	nome feminino	cu|ju|bi|[boi]|a
