cameliácea	nome feminino	ca|me|li|[á]|ce|a
cameliáceo	adjetivo	ca|me|li|[á]|ce|o
camelice	nome feminino	ca|me|[li]|ce
camélida	nome masculino	ca|[mé]|li|da
camelídeo	nome masculino	ca|me|[lí]|de|o
camelídeo	nome masculino	ca|me|[lí]|de|o
camelídeo	adjetivo	ca|me|[lí]|de|o
cameliforme	adjetivo	ca|me|li|[for]|me
camelina	nome feminino	ca|me|[li]|na
camelino	adjetivo	ca|me|[li]|no
camelo	nome masculino	ca|[me]|lo
camelô	nome masculino	ca|me|[lô]
camelopárdale	nome masculino	ca|me|lo|[pár]|da|le
camelopárdale	nome feminino	ca|me|lo|[pár]|da|le
camelopárdalo	nome masculino	ca|me|lo|[pár]|da|lo
camelório	nome masculino	ca|me|[ló]|ri|o
camelornito	nome masculino	ca|me|lor|[ni]|to
camelot	nome masculino	ca|me|lot
camember	nome masculino	ca|mem|[ber]
camembert	nome masculino	ca|mem|bert
camena	nome feminino	ca|[me]|na
câmera	nome feminino	[câ]|me|ra
câmera	nome masculino	[câ]|me|ra
cameral	adjetivo	ca|me|[ral]
cameraman	nome masculino	ca|me|ra|man
camerino	adjetivo	ca|me|[ri]|no
camerino	nome masculino	ca|me|[ri]|no
camerístico	adjetivo	ca|me|[rís]|ti|co
cameritela	nome feminino	ca|me|ri|[te]|la
camerlengado	nome masculino	ca|mer|len|[ga]|do
camerlengo	nome masculino	ca|mer|[len]|go
cameróstomo	nome masculino	ca|me|[rós]|to|mo
camerte	adjetivo	ca|[mer]|te
camerte	nome masculino	ca|[mer]|te
camerte	nome feminino	ca|[mer]|te
camérula	nome feminino	ca|[mé]|ru|la
camerunga	nome feminino	ca|me|[run]|ga
cametaú	nome masculino	ca|me|ta|[ú]
camião	nome masculino	ca|mi|[ão]
camião-cisterna	nome masculino	ca|mi|ão-cis|[ter]|na
camião-reboque	nome masculino	ca|mi|ão-re|[bo]|que
camião-tanque	nome masculino	ca|mi|ão-tan|que
camicase	nome masculino	ca|mi|[ca]|se
camicase	nome feminino	ca|mi|[ca]|se
camila	nome feminino	ca|[mi]|la
camilesco	adjetivo	ca|mi|[les]|co
camilha	nome feminino	ca|[mi]|lha
camiliana	nome feminino	ca|mi|li|[a]|na
camilianismo	nome masculino	ca|mi|li|a|[nis]|mo
camilianista	nome masculino	ca|mi|li|a|[nis]|ta
camilianista	nome feminino	ca|mi|li|a|[nis]|ta
camilianista	adjetivo	ca|mi|li|a|[nis]|ta
camiliano	adjetivo	ca|mi|li|[a]|no
camiliano	nome masculino	ca|mi|li|[a]|no
camilismo	nome masculino	ca|mi|[lis]|mo
camilista	nome masculino	ca|mi|[lis]|ta
camilista	nome feminino	ca|mi|[lis]|ta
camilo	adjetivo	ca|[mi]|lo
camilo	nome masculino	ca|[mi]|lo
camilonga	nome feminino	ca|mi|[lon]|ga
camim	nome masculino	ca|[mim]
camina	nome feminino	ca|[mi]|na
caminhada	nome feminino	ca|mi|[nha]|da
caminhador	adjetivo	ca|mi|nha|[dor]
caminhador	nome masculino	ca|mi|nha|[dor]
caminhante	adjetivo	ca|mi|[nhan]|te
caminhante	nome masculino	ca|mi|[nhan]|te
caminhante	nome feminino	ca|mi|[nhan]|te
caminhão	nome masculino	ca|mi|[nhão]
caminhar	verbo	ca|mi|[nhar]
caminheira	nome feminino	ca|mi|[nhei]|ra
caminheiro	nome masculino	ca|mi|[nhei]|ro
caminheiro	adjetivo	ca|mi|[nhei]|ro
caminhense	nome masculino	ca|mi|[nhen]|se
caminhense	adjetivo	ca|mi|[nhen]|se
caminhense	nome feminino	ca|mi|[nhen]|se
caminheta	nome feminino	ca|mi|[nhe]|ta
caminho	nome masculino	ca|[mi]|nho
caminho de ferro	nome masculino	ca|[mi]|nho de fer|ro
caminhoneiro	adjetivo	ca|mi|nho|[nei]|ro
caminhoneiro	nome masculino	ca|mi|nho|[nei]|ro
caminhonete	nome feminino	ca|mi|nho|[ne]|te
caminologia	nome feminino	ca|mi|no|lo|[gi]|a
caminológico	adjetivo	ca|mi|no|[ló]|gi|co
caminotecnia	nome feminino	ca|mi|no|tec|[ni]|a
caminotécnico	adjetivo	ca|mi|no|[téc]|ni|co
camionagem	nome feminino	ca|mi|o|[na]|gem
camioneta	nome feminino	ca|mi|o|[ne]|ta
camionete	nome feminino	ca|mi|o|[ne]|te
camionista	nome masculino	ca|mi|o|[nis]|ta
camiranga	nome masculino	ca|mi|[ran]|ga
camisa	nome feminino	ca|[mi]|sa
camisa de força	nome feminino	ca|[mi]|sa de for|ça
camisa de forças	nome feminino	ca|[mi]|sa de for|ças
camisa de onze varas	nome feminino	ca|[mi]|sa de on|ze va|ras
camisa de Vénus	nome feminino	ca|[mi]|sa de Vé|nus
camisa de Vênus	nome feminino	ca|[mi]|sa de Vê|nus
camisão	nome masculino	ca|mi|[são]
camisaria	nome feminino	ca|mi|sa|[ri]|a
camiseira	nome feminino	ca|mi|[sei]|ra
