camiseiro	adjetivo	ca|mi|[sei]|ro
camiseiro	nome masculino	ca|mi|[sei]|ro
camiseta	nome feminino	ca|mi|[se]|ta
camisete	nome feminino	ca|mi|[se]|te
camisinha	nome feminino	ca|mi|[si]|nha
camisola	nome feminino	ca|mi|[so]|la
camisoleiro	nome masculino	ca|mi|so|[lei]|ro
camisote	nome masculino	ca|mi|[so]|te
camisu	nome masculino	ca|mi|[su]
camita	adjetivo	ca|[mi]|ta
camita	nome masculino	ca|[mi]|ta
camita	nome feminino	ca|[mi]|ta
camítico	adjetivo	ca|[mí]|ti|co
camito-semítico	adjetivo	ca|mi|to-se|[mí]|ti|co
camito-semítico	nome masculino	ca|mi|to-se|[mí]|ti|co
camixi	nome masculino	ca|mi|[xi]
camoatim	nome masculino	ca|mo|a|[tim]
camoca	nome feminino	ca|[mo]|ca
camocho	nome masculino	ca|[mo]|cho
camocica	nome masculino	ca|mo|[ci]|ca
camoeca	nome feminino	ca|mo|[e]|ca
camoês	nome masculino	ca|mo|[ês]
camoês	adjetivo	ca|mo|[ês]
camoesa	nome feminino	ca|mo|[e]|sa
camoiro	adjetivo	ca|[moi]|ro
camolenga	nome feminino	ca|mo|[len]|ga
camomila	nome feminino	ca|mo|[mi]|la
camomilha	nome feminino	ca|mo|[mi]|lha
camondongo	nome masculino	ca|mon|[don]|go
camone	nome masculino	ca|[mo]|ne
camoniana	nome feminino	ca|mo|ni|[a]|na
camonianismo	nome masculino	ca|mo|ni|a|[nis]|mo
camonianista	nome masculino	ca|mo|ni|a|[nis]|ta
camonianista	nome feminino	ca|mo|ni|a|[nis]|ta
camonianista	adjetivo	ca|mo|ni|a|[nis]|ta
camoniano	adjetivo	ca|mo|ni|[a]|no
camoniano	nome masculino	ca|mo|ni|[a]|no
camonismo	nome masculino	ca|mo|[nis]|mo
camonista	adjetivo	ca|mo|[nis]|ta
camonista	nome masculino	ca|mo|[nis]|ta
camonista	nome feminino	ca|mo|[nis]|ta
camonologia	nome feminino	ca|mo|no|lo|[gi]|a
camonológico	adjetivo	ca|mo|no|[ló]|gi|co
camonólogo	nome masculino	ca|mo|[nó]|lo|go
camopim	nome masculino	ca|mo|[pim]
camoquenque	nome masculino	ca|mo|[quen]|que
camorra	nome feminino	ca|[mor]|ra
camorrismo	nome masculino	ca|mor|[ris]|mo
camorrista	adjetivo	ca|mor|[ris]|ta
camorrista	nome masculino	ca|mor|[ris]|ta
camorrista	nome feminino	ca|mor|[ris]|ta
camote	nome masculino	ca|[mo]|te
camotim	nome masculino	ca|mo|[tim]
camouco	nome masculino	ca|[mou]|co
camouro	adjetivo	ca|[mou]|ro
camp	nome masculino	[camp]
campa	nome feminino	[cam]|pa
campa	nome masculino	[cam]|pa
campação	nome feminino	cam|pa|[ção]
campada	nome feminino	cam|[pa]|da
campador	nome masculino	cam|pa|[dor]
campainha	nome feminino	cam|pa|[i]|nha
campainha-azul	nome feminino	cam|pa|i|nha-a|[zul]
campainhada	nome feminino	cam|pa|i|[nha]|da
campainhão	nome masculino	cam|pa|i|[nhão]
campainheiro	nome masculino	cam|pa|i|[nhei]|ro
campal	adjetivo	cam|[pal]
campana	nome feminino	cam|[pa]|na
campanado	adjetivo	cam|pa|[na]|do
campanário	nome masculino	cam|pa|[ná]|ri|o
campaneiro	nome masculino	cam|pa|[nei]|ro
campanha	nome feminino	cam|[pa]|nha
campanhista	nome masculino	cam|pa|[nhis]|ta
campanhol	nome masculino	cam|pa|[nhol]
campaniano	adjetivo	cam|pa|ni|[a]|no
campaniço	adjetivo	cam|pa|[ni]|ço
campaniço	nome masculino	cam|pa|[ni]|ço
campânico	nome masculino	cam|[pâ]|ni|co
campaniense	nome masculino	cam|pa|ni|[en]|se
campaniense	adjetivo	cam|pa|ni|[en]|se
campaniense	nome feminino	cam|pa|ni|[en]|se
campanifloro	adjetivo	cam|pa|ni|[flo]|ro
campaniforme	adjetivo	cam|pa|ni|[for]|me
campanil	nome masculino	cam|pa|[nil]
campanilho	nome masculino	cam|pa|[ni]|lho
campanilo	nome masculino	cam|pa|[ni]|lo
campano	adjetivo	cam|[pa]|no
campano	nome masculino	cam|[pa]|no
campanologia	nome feminino	cam|pa|no|lo|[gi]|a
campanólogo	nome masculino	cam|pa|[nó]|lo|go
campanomania	nome feminino	cam|pa|no|ma|[ni]|a
campanudo	adjetivo	cam|pa|[nu]|do
campânula	nome feminino	cam|[pâ]|nu|la
campanulácea	nome feminino	cam|pa|nu|[lá]|ce|a
campanuláceo	adjetivo	cam|pa|nu|[lá]|ce|o
campanulado	adjetivo	cam|pa|nu|[la]|do
campanular	adjetivo	cam|pa|nu|[lar]
campanulária	nome feminino	cam|pa|nu|[lá]|ri|a
campanulifloro	adjetivo	cam|pa|nu|li|[flo]|ro
campanuliforme	adjetivo	cam|pa|nu|li|[for]|me
