cão de guarda	nome masculino	cão de guar|da
cão-do-mar	nome masculino	[cão-do-mar]
cão-guia	nome masculino	cão-gui|a
cão-marinho	nome masculino	cão-ma|[ri]|nho
cão-polícia	nome masculino	cão-po|[lí]|ci|a
cão-tinhoso	nome masculino	cão-ti|[nho]|so
caoba	nome feminino	ca|[o]|ba
caoco	nome masculino	ca|[o]|co
caol	nome masculino	ca|[ol]
caolho	adjetivo	ca|[o]|lho
caolho	nome masculino	ca|[o]|lho
caombo	nome masculino	ca|[om]|bo
cáone	adjetivo	[cá]|o|ne
cáone	nome masculino	[cá]|o|ne
cáone	nome feminino	[cá]|o|ne
caônio	adjetivo	ca|[ô]|ni|o
caónio	adjetivo	ca|[ó]|ni|o
caos	nome masculino	[caos]
caoticamente	advérbio	ca|o|ti|ca|[men]|te
caótico	adjetivo	ca|[ó]|ti|co
caotizar	verbo	ca|o|ti|[zar]
caoutchouc	nome masculino	caou|tchouc
cãozeiro	adjetivo	[cão]|zei|ro
cãozeiro	nome masculino	[cão]|zei|ro
capa	nome feminino	[ca]|pa
capa	nome masculino	[ca]|pa
capa de chuva	nome feminino	[ca]|pa de chu|va
capa-homem	nome masculino	ca|pa-ho|mem
capa-rota	nome feminino	ca|pa-ro|ta
capação	nome feminino	ca|pa|[ção]
capaceia	nome feminino	ca|pa|[cei]|a
capacete	nome masculino	ca|pa|[ce]|te
capacha	nome feminino	ca|[pa]|cha
capacheiro	nome masculino	ca|pa|[chei]|ro
capachice	nome feminino	ca|pa|[chi]|ce
capachinho	nome masculino	ca|pa|[chi]|nho
capachismo	nome masculino	ca|pa|[chis]|mo
capacho	nome masculino	ca|[pa]|cho
capacidade	nome feminino	ca|pa|ci|[da]|de
capacíssimo	adjetivo	ca|pa|[cís]|si|mo
capacitado	adjetivo	ca|pa|ci|[ta]|do
capacitar	verbo	ca|pa|ci|[tar]
capacitativo	adjetivo	ca|pa|ci|ta|[ti]|vo
capacitável	adjetivo	ca|pa|ci|[tá]|vel
capada	nome feminino	ca|[pa]|da
capadaria	nome feminino	ca|pa|da|[ri]|a
capadeira	nome feminino	ca|pa|[dei]|ra
capadeiro	nome masculino	ca|pa|[dei]|ro
capadete	nome masculino	ca|pa|[de]|te
capado	nome masculino	ca|[pa]|do
capado	adjetivo	ca|[pa]|do
capadoçada	nome feminino	ca|pa|do|[ça]|da
capadoçagem	nome feminino	ca|pa|do|[ça]|gem
capadoçal	adjetivo	ca|pa|do|[çal]
capádoce	adjetivo	ca|[pá]|do|ce
capádoce	nome masculino	ca|[pá]|do|ce
capádoce	nome feminino	ca|[pá]|do|ce
capadócia	nome feminino	ca|pa|[dó]|ci|a
capadócio	nome masculino	ca|pa|[dó]|ci|o
capadócio	adjetivo	ca|pa|[dó]|ci|o
capador	nome masculino	ca|pa|[dor]
capadura	nome feminino	ca|pa|[du]|ra
capaia	nome feminino	ca|[pai]|a
capanda	nome feminino	ca|[pan]|da
capandua	nome feminino	ca|pan|[du]|a
capanema	nome masculino	ca|pa|[ne]|ma
capanga	nome masculino	ca|[pan]|ga
capanga	nome feminino	ca|[pan]|ga
capangada	nome feminino	ca|pan|[ga]|da
capangagem	nome feminino	ca|pan|[ga]|gem
capangar	verbo	ca|pan|[gar]
capangueiro	nome masculino	ca|pan|[guei]|ro
capão	nome masculino	ca|[pão]
capão	adjetivo	ca|[pão]
capar	verbo	ca|[par]
capara	nome feminino	ca|[pa]|ra
caparação	nome masculino	ca|pa|ra|[ção]
caparaçonado	adjetivo	ca|pa|ra|ço|[na]|do
caparão	nome masculino	ca|pa|[rão]
caparazão	nome masculino	ca|pa|ra|[zão]
capariácea	nome feminino	ca|pa|ri|[á]|ce|a
caparicano	adjetivo	ca|pa|ri|[ca]|no
caparicano	nome masculino	ca|pa|ri|[ca]|no
caparidácea	nome feminino	ca|pa|ri|[dá]|ce|a
caparidáceo	adjetivo	ca|pa|ri|[dá]|ce|o
capariquense	adjetivo	ca|pa|ri|[quen]|se
capariquense	nome masculino	ca|pa|ri|[quen]|se
capariquense	nome feminino	ca|pa|ri|[quen]|se
caparitano	nome masculino	ca|pa|ri|[ta]|no
caparitano	adjetivo	ca|pa|ri|[ta]|no
caparoeiro	adjetivo	ca|pa|ro|[ei]|ro
caparoroca	nome feminino	ca|pa|ro|[ro]|ca
caparrosa	nome feminino	ca|par|[ro]|sa
capataço	nome masculino	ca|pa|[ta]|ço
capatão	nome masculino	ca|pa|[tão]
capataz	nome masculino	ca|pa|[taz]
capatazar	verbo	ca|pa|ta|[zar]
capatazia	nome feminino	ca|pa|ta|[zi]|a
capatázio	adjetivo	ca|pa|[tá]|zi|o
capatázio	nome masculino	ca|pa|[tá]|zi|o
