cacau	nome masculino	ca|[cau]
cacau-azul	nome masculino	ca|cau-a|[zul]
cacaual	nome masculino	ca|cau|[al]
cacaué	nome masculino	ca|cau|[é]
cacaueiro	nome masculino	ca|cau|[ei]|ro
cacaueiro	adjetivo	ca|cau|[ei]|ro
cacaueiro-soconusco	nome masculino	ca|cau|ei|ro-so|co|[nus]|co
cacauí	nome masculino	ca|cau|[í]
cacaurana	nome feminino	ca|cau|[ra]|na
cacauzal	nome masculino	ca|cau|[zal]
cacauzeiral	nome masculino	ca|cau|zei|[ral]
cacauzeiro	nome masculino	ca|cau|[zei]|ro
caçava	nome feminino	ca|[ça]|va
caçave	nome masculino	ca|[ça]|ve
caccínea	nome feminino	cac|[cí]|ne|a
cacear	verbo	ca|ce|[ar]
caceia	nome feminino	ca|[cei]|a
caceio	nome masculino	ca|[cei]|o
caceta	nome feminino	ca|[ce]|ta
cacetada	nome feminino	ca|ce|[ta]|da
cacetar	verbo	ca|ce|[tar]
cacete	adjetivo	ca|[ce]|te
cacete	nome masculino	ca|[ce]|te
caceteação	nome feminino	ca|ce|te|a|[ção]
caceteador	adjetivo	ca|ce|te|a|[dor]
caceteador	nome masculino	ca|ce|te|a|[dor]
cacetear	verbo	ca|ce|te|[ar]
caceteira	nome feminino	ca|ce|[tei]|ra
caceteiro	nome masculino	ca|ce|[tei]|ro
cacha	nome feminino	[ca]|cha
cachaça	nome feminino	ca|[cha]|ça
cachaça	nome masculino	ca|[cha]|ça
cachaçada	nome feminino	ca|cha|[ça]|da
cachação	nome masculino	ca|cha|[ção]
cachaceira	nome feminino	ca|cha|[cei]|ra
cachaceiro	adjetivo	ca|cha|[cei]|ro
cachacipançudo	adjetivo	ca|cha|ci|pan|[çu]|do
cachaço	nome masculino	ca|[cha]|ço
cachaçuda	nome feminino	ca|cha|[çu]|da
cachaçudo	adjetivo	ca|cha|[çu]|do
cachaçudo	nome masculino	ca|cha|[çu]|do
cachada	nome feminino	ca|[cha]|da
cachafosgo	nome masculino	ca|cha|[fos]|go
cachafundo	nome masculino	ca|cha|[fun]|do
cachagens	nome feminino	ca|[cha]|gens
cachalote	nome masculino	ca|cha|[lo]|te
cachamorra	nome feminino	ca|cha|[mor]|ra
cachamorrada	nome feminino	ca|cha|mor|[ra]|da
cachamorreiro	nome masculino	ca|cha|mor|[rei]|ro
cachão	nome masculino	ca|[chão]
cachapeira	nome feminino	ca|cha|[pei]|ra
cachapeiro	nome masculino	ca|cha|[pei]|ro
cachapim	nome masculino	ca|cha|[pim]
cachaporra	nome feminino	ca|cha|[por]|ra
cachaporrada	nome feminino	ca|cha|por|[ra]|da
cachapuço	nome masculino	ca|cha|[pu]|ço
cachapuz	interjeição	ca|cha|[puz]
cachar	verbo	ca|[char]
cacharamba	nome feminino	ca|cha|[ram]|ba
cacharolete	nome masculino	ca|cha|ro|[le]|te
cachatim	nome masculino	ca|cha|[tim]
cache	nome feminino	[ca]|che
cache	nome masculino	[ca]|che
cachê	nome masculino	ca|[chê]
caché	nome masculino	ca|[ché]
cache-pot	nome masculino	ca|che-pot
cache-sexe	nome masculino	ca|che-se|xe
cacheada	nome feminino	ca|che|[a]|da
cacheadeira	nome feminino	ca|che|a|[dei]|ra
cacheado	adjetivo	ca|che|[a]|do
cachear	verbo	ca|che|[ar]
cachecol	nome masculino	ca|che|[col]
cacheira	nome feminino	ca|[chei]|ra
cacheirada	nome feminino	ca|chei|[ra]|da
cacheiro	nome masculino	ca|[chei]|ro
cacheiro	adjetivo	ca|[chei]|ro
cachenê	nome masculino	ca|che|[nê]
cachené	nome masculino	ca|che|[né]
cachepô	nome masculino	ca|che|[pô]
cacherá	nome masculino	ca|che|[rá]
cachet	nome masculino	ca|chet
cacheta	nome feminino	ca|[che]|ta
cachetar	verbo	ca|che|[tar]
cachete	nome masculino	ca|[che]|te
cachia	nome feminino	ca|[chi]|a
cachiça	nome feminino	ca|[chi]|ça
cachicha	interjeição	ca|[chi]|cha
cachiço	nome masculino	ca|[chi]|ço
cachico	nome masculino	ca|[chi]|co
cachilro	nome masculino	ca|[chil]|ro
cachimanha	nome feminino	ca|chi|[ma]|nha
cachimbada	nome feminino	ca|chim|[ba]|da
cachimbador	adjetivo	ca|chim|ba|[dor]
cachimbador	nome masculino	ca|chim|ba|[dor]
cachimbar	verbo	ca|chim|[bar]
cachimbo	nome masculino	ca|[chim]|bo
cachimbo-de-jabuti	nome masculino	ca|chim|bo-de-ja|bu|[ti]
cachimónia	nome feminino	ca|chi|[mó]|ni|a
cachimônia	nome feminino	ca|chi|[mô]|ni|a
cachinada	nome feminino	ca|chi|[na]|da
