catarreira	nome feminino	ca|tar|[rei]|ra
catarrento	adjetivo	ca|tar|[ren]|to
catarrético	adjetivo	ca|tar|[ré]|ti|co
catarreu	adjetivo	ca|tar|[reu]
catarreu	nome masculino	ca|tar|[reu]
catarríneo	nome masculino	ca|tar|[rí]|ne|o
catarrino	nome masculino	ca|tar|[ri]|no
catarro	nome masculino	ca|[tar]|ro
catarroso	adjetivo	ca|tar|[ro]|so
catarse	nome feminino	ca|[tar]|se
catarsia	nome feminino	ca|tar|[si]|a
catarta	nome masculino	ca|[tar]|ta
catarticamente	advérbio	ca|tar|ti|ca|[men]|te
catártico	adjetivo	ca|[tár]|ti|co
catártico	nome masculino	ca|[tár]|ti|co
catartídeo	nome masculino	ca|tar|[tí]|de|o
catartídeo	adjetivo	ca|tar|[tí]|de|o
catartídeo	nome masculino	ca|tar|[tí]|de|o
catartina	nome feminino	ca|tar|[ti]|na
catartínico	adjetivo	ca|tar|[tí]|ni|co
catartismo	nome masculino	ca|tar|[tis]|mo
catas-altense	adjetivo	ca|tas-al|[ten]|se
catas-altense	nome masculino	ca|tas-al|[ten]|se
catas-altense	nome feminino	ca|tas-al|[ten]|se
catasseto	nome masculino	ca|tas|[se]|to
catassol	nome masculino	ca|tas|[sol]
catasta	nome feminino	ca|[tas]|ta
catástase	nome feminino	ca|[tás]|ta|se
catastático	adjetivo	ca|tas|[tá]|ti|co
catástrofe	nome feminino	ca|[tás]|tro|fe
catastroficamente	advérbio	ca|tas|tro|fi|ca|[men]|te
catastrófico	adjetivo	ca|tas|[tró]|fi|co
catastrofismo	nome masculino	ca|tas|tro|[fis]|mo
catastrofista	adjetivo	ca|tas|tro|[fis]|ta
catastrofista	nome masculino	ca|tas|tro|[fis]|ta
catastrofista	nome feminino	ca|tas|tro|[fis]|ta
catastrofístico	adjetivo	ca|tas|tro|[fís]|ti|co
catatau	nome masculino	ca|ta|[tau]
catatermômetro	nome masculino	ca|ta|ter|[mô]|me|tro
catatermómetro	nome masculino	ca|ta|ter|[mó]|me|tro
catato	nome masculino	ca|[ta]|to
catatonia	nome feminino	ca|ta|to|[ni]|a
catatônico	adjetivo	ca|ta|[tô]|ni|co
catatónico	adjetivo	ca|ta|[tó]|ni|co
catatraz	interjeição	ca|ta|[traz]
catatua	nome feminino	ca|ta|[tu]|a
catatuá	nome masculino	ca|ta|tu|[á]
catau	nome masculino	ca|[tau]
catauari	nome masculino	ca|tau|a|[ri]
catazona	nome feminino	ca|ta|[zo]|na
catchorona	nome feminino	cat|cho|[ro]|na
catchupa	nome feminino	cat|[chu]|pa
cate	nome masculino	[ca]|te
catear	verbo	ca|te|[ar]
catébi	nome masculino	ca|[té]|bi
catechu	nome masculino	ca|te|[chu]
catechueira	nome feminino	ca|te|chu|[ei]|ra
catechueiro	nome masculino	ca|te|chu|[ei]|ro
catecismo	nome masculino	ca|te|[cis]|mo
catecolamina	nome feminino	ca|te|co|la|[mi]|na
catecúmena	nome feminino	ca|te|[cú]|me|na
catecumenado	nome masculino	ca|te|cu|me|[na]|do
catecumenato	nome masculino	ca|te|cu|me|[na]|to
catecúmeno	nome masculino	ca|te|[cú]|me|no
cátedra	nome feminino	[cá]|te|dra
catedrádego	nome masculino	ca|te|[drá]|de|go
catedral	adjetivo	ca|te|[dral]
catedral	nome feminino	ca|te|[dral]
catedralesco	adjetivo	ca|te|dra|[les]|co
catedrante	nome masculino	ca|te|[dran]|te
catedrática	nome feminino	ca|te|[drá]|ti|ca
catedraticamente	advérbio	ca|te|dra|ti|ca|[men]|te
catedrático	nome masculino	ca|te|[drá]|ti|co
catedrático	adjetivo	ca|te|[drá]|ti|co
catedratismo	nome masculino	ca|te|dra|[tis]|mo
catedratizar	verbo	ca|te|dra|ti|[zar]
catedrilha	nome feminino	ca|te|[dri]|lha
categorema	nome masculino	ca|te|go|[re]|ma
categoremático	adjetivo	ca|te|go|re|[má]|ti|co
categoria	nome feminino	ca|te|go|[ri]|a
categorial	adjetivo	ca|te|go|ri|[al]
categoricamente	advérbio	ca|te|go|ri|ca|[men]|te
categórico	adjetivo	ca|te|[gó]|ri|co
categórico-dedutivo	adjetivo	ca|te|gó|ri|co-de|du|[ti]|vo
categorismo	nome masculino	ca|te|go|[ris]|mo
categorização	nome feminino	ca|te|go|ri|za|[ção]
categorizado	adjetivo	ca|te|go|ri|[za]|do
categorizador	adjetivo	ca|te|go|ri|za|[dor]
categorizador	nome masculino	ca|te|go|ri|za|[dor]
categorizar	verbo	ca|te|go|ri|[zar]
categorizável	adjetivo	ca|te|go|ri|[zá]|vel
cateia	nome feminino	ca|[tei]|a
catejuá	nome masculino	ca|te|ju|[á]
catembe	nome feminino	ca|[tem]|be
catena	nome feminino	ca|[te]|na
catenação	nome feminino	ca|te|na|[ção]
catenária	nome feminino	ca|te|[ná]|ri|a
catenário	nome masculino	ca|te|[ná]|ri|o
catenatício	nome masculino	ca|te|na|[tí]|ci|o
catenífero	adjetivo	ca|te|[ní]|fe|ro
