exagerável	adjetivo	e|xa|ge|[rá]|vel
exagero	nome masculino	e|xa|[ge]|ro
exagitação	nome feminino	e|xa|gi|ta|[ção]
exagitante	adjetivo	e|xa|gi|[tan]|te
exagitar	verbo	e|xa|gi|[tar]
exalação	nome feminino	e|xa|la|[ção]
exalante	adjetivo	e|xa|[lan]|te
exalar	verbo	e|xa|[lar]
exalbuminado	adjetivo	e|xal|bu|mi|[na]|do
exalbuminoso	adjetivo	e|xal|bu|mi|[no]|so
exalçação	nome feminino	e|xal|ça|[ção]
exalçado	adjetivo	e|xal|[ça]|do
exalçador	adjetivo	e|xal|ça|[dor]
exalçador	nome masculino	e|xal|ça|[dor]
exalçamento	nome masculino	e|xal|ça|[men]|to
exalçar	verbo	e|xal|[çar]
exalçável	adjetivo	e|xal|[çá]|vel
exalgina	nome feminino	e|xal|[gi]|na
exaltação	nome feminino	e|xal|ta|[ção]
exaltada	nome feminino	e|xal|[ta]|da
exaltadamente	advérbio	e|xal|ta|da|[men]|te
exaltado	adjetivo	e|xal|[ta]|do
exaltado	nome masculino	e|xal|[ta]|do
exaltador	adjetivo	e|xal|ta|[dor]
exaltador	nome masculino	e|xal|ta|[dor]
exaltamento	nome masculino	e|xal|ta|[men]|to
exaltante	adjetivo	e|xal|[tan]|te
exaltar	verbo	e|xal|[tar]
exaltável	adjetivo	e|xal|[tá]|vel
exalviçado	adjetivo	e|xal|vi|[ça]|do
exame	nome masculino	e|[xa]|me
examina	nome feminino	e|xa|[mi]|na
examinação	nome feminino	e|xa|mi|na|[ção]
examinado	adjetivo	e|xa|mi|[na]|do
examinador	adjetivo	e|xa|mi|na|[dor]
examinador	nome masculino	e|xa|mi|na|[dor]
examinadora	nome feminino	e|xa|mi|na|[do]|ra
examinando	nome masculino	e|xa|mi|[nan]|do
examinante	adjetivo	e|xa|mi|[nan]|te
examinar	verbo	e|xa|mi|[nar]
examinável	adjetivo	e|xa|mi|[ná]|vel
exangue	adjetivo	e|[xan]|gue
exania	nome feminino	e|xa|[ni]|a
exanimação	nome feminino	e|xa|ni|ma|[ção]
exanimado	adjetivo	e|xa|ni|[ma]|do
exânime	adjetivo	e|[xâ]|ni|me
exantema	nome masculino	e|xan|[te]|ma
exantemático	adjetivo	e|xan|te|[má]|ti|co
exantematoso	adjetivo	e|xan|te|ma|[to]|so
exão	nome masculino	e|[xão]
exaração	nome feminino	e|xa|ra|[ção]
exarar	verbo	e|xa|[rar]
exarca	nome masculino	e|[xar]|ca
exarcado	nome masculino	e|xar|[ca]|do
exárcia	nome feminino	e|[xár]|ci|a
exarco	nome masculino	e|[xar]|co
exarquia	nome feminino	e|xar|[qui]|a
exarticulação	nome feminino	e|xar|ti|cu|la|[ção]
exarticular	verbo	e|xar|ti|cu|[lar]
exartrema	nome masculino	e|xar|[tre]|ma
exartrose	nome feminino	e|xar|[tro]|se
exáscea	nome feminino	e|[xás]|ce|a
exasperação	nome feminino	e|xas|pe|ra|[ção]
exasperadamente	advérbio	e|xas|pe|ra|da|[men]|te
exasperado	adjetivo	e|xas|pe|[ra]|do
exasperador	adjetivo	e|xas|pe|ra|[dor]
exasperador	nome masculino	e|xas|pe|ra|[dor]
exasperadora	nome feminino	e|xas|pe|ra|[do]|ra
exasperante	adjetivo	e|xas|pe|[ran]|te
exasperar	verbo	e|xas|pe|[rar]
exasperável	adjetivo	e|xas|pe|[rá]|vel
exaspero	nome masculino	e|xas|[pe]|ro
exatamente	advérbio	e|xa|ta|[men]|te
exatidão	nome feminino	e|xa|ti|[dão]
exatificar	verbo	e|xa|ti|fi|[car]
exatissimamente	advérbio	e|xa|tis|si|ma|[men]|te
exatíssimo	adjetivo	e|xa|[tís]|si|mo
exato	adjetivo	e|[xa]|to
exator	nome masculino	e|xa|[tor]
exatoria	nome feminino	e|xa|to|[ri]|a
exaurição	nome feminino	e|xau|ri|[ção]
exaurido	adjetivo	e|xau|[ri]|do
exaurimento	nome masculino	e|xau|ri|[men]|to
exaurir	verbo	e|xau|[rir]
exaurível	adjetivo	e|xau|[rí]|vel
exaustação	nome feminino	e|xaus|ta|[ção]
exaustante	adjetivo	e|xaus|[tan]|te
exaustão	nome feminino	e|xaus|[tão]
exaustar	verbo	e|xaus|[tar]
exaustivamente	advérbio	e|xaus|ti|va|[men]|te
exaustivo	adjetivo	e|xaus|[ti]|vo
exausto	adjetivo	e|[xaus]|to
exaustor	nome masculino	e|xaus|[tor]
exautoração	nome feminino	e|xau|to|ra|[ção]
exautorado	adjetivo	e|xau|to|[ra]|do
exautorador	adjetivo	e|xau|to|ra|[dor]
exautorador	nome masculino	e|xau|to|ra|[dor]
exautorar	verbo	e|xau|to|[rar]
excarceração	nome feminino	ex|car|ce|ra|[ção]
excarcerar	verbo	ex|car|ce|[rar]
