explosivo	nome masculino	ex|plo|[si]|vo
explosivo	adjetivo	ex|plo|[si]|vo
expluir	verbo	ex|plu|[ir]
expo	nome feminino	[ex]|po
expoente	nome masculino	ex|po|[en]|te
expoente	nome feminino	ex|po|[en]|te
expolição	nome feminino	ex|po|li|[ção]
expolir	verbo	ex|po|[lir]
exponenciação	nome feminino	ex|po|nen|ci|a|[ção]
exponencial	adjetivo	ex|po|nen|ci|[al]
exponencial	nome feminino	ex|po|nen|ci|[al]
exponencialmente	advérbio	ex|po|nen|ci|al|[men]|te
exponenciar	verbo	ex|po|nen|ci|[ar]
exponente	adjetivo	ex|po|[nen]|te
exponente	nome masculino	ex|po|[nen]|te
exponente	nome feminino	ex|po|[nen]|te
exponential	nome feminino	ex|po|nen|ti|[al]
expor	verbo	ex|[por]
exportação	nome feminino	ex|por|ta|[ção]
exportador	adjetivo	ex|por|ta|[dor]
exportador	nome masculino	ex|por|ta|[dor]
exportadora	nome feminino	ex|por|ta|[do]|ra
exportar	verbo	ex|por|[tar]
exportável	adjetivo	ex|por|[tá]|vel
exposição	nome feminino	ex|po|si|[ção]
expositivamente	advérbio	ex|po|si|ti|va|[men]|te
expositivo	adjetivo	ex|po|si|[ti]|vo
expósito	nome masculino	ex|[pó]|si|to
expositor	nome masculino	ex|po|si|[tor]
expositor	adjetivo	ex|po|si|[tor]
expositora	nome feminino	ex|po|si|[to]|ra
exposto	adjetivo	ex|[pos]|to
exposto	nome masculino	ex|[pos]|to
expostulação	nome feminino	ex|pos|tu|la|[ção]
expostular	verbo	ex|pos|tu|[lar]
expressador	adjetivo	ex|pres|sa|[dor]
expressamente	advérbio	ex|pres|sa|[men]|te
expressão	nome feminino	ex|pres|[são]
expressar	verbo	ex|pres|[sar]
expressável	adjetivo	ex|pres|[sá]|vel
expressional	adjetivo	ex|pres|si|o|[nal]
expressionalmente	advérbio	ex|pres|si|o|nal|[men]|te
expressionismo	nome masculino	ex|pres|si|o|[nis]|mo
expressionista	nome masculino	ex|pres|si|o|[nis]|ta
expressionista	adjetivo	ex|pres|si|o|[nis]|ta
expressionista	nome feminino	ex|pres|si|o|[nis]|ta
expressionístico	adjetivo	ex|pres|si|o|[nís]|ti|co
expressiva	nome feminino	ex|pres|[si]|va
expressivamente	advérbio	ex|pres|si|va|[men]|te
expressividade	nome feminino	ex|pres|si|vi|[da]|de
expressivo	adjetivo	ex|pres|[si]|vo
expresso	nome masculino	ex|[pres]|so
expresso	adjetivo	ex|[pres]|so
expressor	adjetivo	ex|pres|[sor]
expressor	nome masculino	ex|pres|[sor]
exprimir	verbo	ex|pri|[mir]
exprimível	adjetivo	ex|pri|[mí]|vel
exprobração	nome feminino	ex|pro|bra|[ção]
exprobrado	adjetivo	ex|pro|[bra]|do
exprobrador	adjetivo	ex|pro|bra|[dor]
exprobrador	nome masculino	ex|pro|bra|[dor]
exprobrante	adjetivo	ex|pro|[bran]|te
exprobrante	nome masculino	ex|pro|[bran]|te
exprobrante	nome feminino	ex|pro|[bran]|te
exprobrar	verbo	ex|pro|[brar]
exprobratório	adjetivo	ex|pro|bra|[tó]|ri|o
exprobrável	adjetivo	ex|pro|[brá]|vel
expromissor	nome masculino	ex|pro|mis|[sor]
expropriação	nome feminino	ex|pro|pri|a|[ção]
expropriador	adjetivo	ex|pro|pri|a|[dor]
expropriador	nome masculino	ex|pro|pri|a|[dor]
expropriadora	nome feminino	ex|pro|pri|a|[do]|ra
expropriante	adjetivo	ex|pro|pri|[an]|te
expropriar	verbo	ex|pro|pri|[ar]
expropriativo	adjetivo	ex|pro|pri|a|[ti]|vo
expropriatório	adjetivo	ex|pro|pri|a|[tó]|ri|o
expropriável	adjetivo	ex|pro|pri|[á]|vel
expugnação	nome feminino	ex|pug|na|[ção]
expugnador	adjetivo	ex|pug|na|[dor]
expugnador	nome masculino	ex|pug|na|[dor]
expugnando	adjetivo	ex|pug|[nan]|do
expugnar	verbo	ex|pug|[nar]
expugnável	adjetivo	ex|pug|[ná]|vel
expuição	nome feminino	ex|pu|i|[ção]
expulsão	nome feminino	ex|pul|[são]
expulsar	verbo	ex|pul|[sar]
expulsável	adjetivo	ex|pul|[sá]|vel
expulsivo	adjetivo	ex|pul|[si]|vo
expulso	adjetivo	ex|[pul]|so
expulsor	adjetivo	ex|pul|[sor]
expulsor	nome masculino	ex|pul|[sor]
expulsório	adjetivo	ex|pul|[só]|ri|o
expultriz	nome feminino	ex|pul|[triz]
expunção	nome feminino	ex|pun|[ção]
expungir	verbo	ex|pun|[gir]
expungível	adjetivo	ex|pun|[gí]|vel
expurgação	nome feminino	ex|pur|ga|[ção]
expurgadão	nome feminino	ex|pur|ga|[dão]
expurgado	adjetivo	ex|pur|[ga]|do
expurgador	adjetivo	ex|pur|ga|[dor]
