esborniar	verbo	es|bor|ni|[ar]
esboroamento	nome masculino	es|bo|ro|a|[men]|to
esboroar	verbo	es|bo|ro|[ar]
esboroo	nome masculino	es|bo|[ro]|o
esborraçar	verbo	es|bor|ra|[çar]
esborrachado	adjetivo	es|bor|ra|[cha]|do
esborrachar	verbo	es|bor|ra|[char]
esborralha	nome feminino	es|bor|[ra]|lha
esborralhada	nome feminino	es|bor|ra|[lha]|da
esborralhadoiro	nome masculino	es|bor|ra|lha|[doi]|ro
esborralhador	adjetivo	es|bor|ra|lha|[dor]
esborralhador	nome masculino	es|bor|ra|lha|[dor]
esborralhadouro	nome masculino	es|bor|ra|lha|[dou]|ro
esborralhar	verbo	es|bor|ra|[lhar]
esborrar	verbo	es|bor|[rar]
esborratadela	nome feminino	es|bor|ra|ta|[de]|la
esborratado	adjetivo	es|bor|ra|[ta]|do
esborratar	verbo	es|bor|ra|[tar]
esborrega	nome feminino	es|bor|[re]|ga
esborregar	verbo	es|bor|re|[gar]
esborrifar	verbo	es|bor|ri|[far]
esborrifo	nome masculino	es|bor|[ri]|fo
esborro	nome masculino	es|[bor]|ro
esbotenadela	nome feminino	es|bo|te|na|[de]|la
esbotenar	verbo	es|bo|te|[nar]
esbouça	nome feminino	es|[bou]|ça
esbouçamento	nome masculino	es|bou|ça|[men]|to
esbouçar	verbo	es|bou|[çar]
esboucelar	verbo	es|bou|ce|[lar]
esbracejar	verbo	es|bra|ce|[jar]
esbraguilhado	adjetivo	es|bra|gui|[lha]|do
esbranquiçado	adjetivo	es|bran|qui|[ça]|do
esbranquiçar	verbo	es|bran|qui|[çar]
esbraseamento	nome masculino	es|bra|se|a|[men]|to
esbraseante	adjetivo	es|bra|se|[an]|te
esbrasear	verbo	es|bra|se|[ar]
esbravear	verbo	es|bra|ve|[ar]
esbravecer	verbo	es|bra|ve|[cer]
esbravejar	verbo	es|bra|ve|[jar]
esbregue	nome masculino	es|[bre]|gue
esbrugar	verbo	es|bru|[gar]
esbugalhado	adjetivo	es|bu|ga|[lha]|do
esbugalhar	verbo	es|bu|ga|[lhar]
esbulhador	adjetivo	es|bu|lha|[dor]
esbulhador	nome masculino	es|bu|lha|[dor]
esbulhar	verbo	es|bu|[lhar]
esbulho	nome masculino	es|[bu]|lho
esburacado	adjetivo	es|bu|ra|[ca]|do
esburacar	verbo	es|bu|ra|[car]
esburgar	verbo	es|bur|[gar]
esbuxar	verbo	es|bu|[xar]
escabeçar	verbo	es|ca|be|[çar]
escabecear	verbo	es|ca|be|ce|[ar]
escabechar	verbo	es|ca|be|[char]
escabeche	nome masculino	es|ca|[be]|che
escabela	nome feminino	es|ca|[be]|la
escabelado	adjetivo	es|ca|be|[la]|do
escabelado	nome masculino	es|ca|be|[la]|do
escabelar	verbo	es|ca|be|[lar]
escabeleirar	verbo	es|ca|be|lei|[rar]
escabelo	nome masculino	es|ca|[be]|lo
escabichador	adjetivo	es|ca|bi|cha|[dor]
escabichador	nome masculino	es|ca|bi|cha|[dor]
escabichar	verbo	es|ca|bi|[char]
escabicheira	nome feminino	es|ca|bi|[chei]|ra
escabiosa	nome feminino	es|ca|bi|[o]|sa
escabiose	nome feminino	es|ca|bi|[o]|se
escabioso	adjetivo	es|ca|bi|[o]|so
escabreação	nome feminino	es|ca|bre|a|[ção]
escabreado	adjetivo	es|ca|bre|[a]|do
escabrear	verbo	es|ca|bre|[ar]
escabro	adjetivo	es|[ca]|bro
escabrosamente	advérbio	es|ca|bro|sa|[men]|te
escabrosidade	nome feminino	es|ca|bro|si|[da]|de
escabroso	adjetivo	es|ca|[bro]|so
escabujamento	nome masculino	es|ca|bu|ja|[men]|to
escabujante	adjetivo	es|ca|bu|[jan]|te
escabujar	verbo	es|ca|bu|[jar]
escabulhar	verbo	es|ca|bu|[lhar]
escabulho	nome masculino	es|ca|[bu]|lho
escacar	verbo	es|ca|[car]
escacha	nome feminino	es|[ca]|cha
escacha-pessegueiro	nome masculino	es|ca|cha-pes|se|[guei]|ro
escachar	verbo	es|ca|[char]
escachelado	adjetivo	es|ca|che|[la]|do
escachoante	adjetivo	es|ca|cho|[an]|te
escachoar	verbo	es|ca|cho|[ar]
escacholar	verbo	es|ca|cho|[lar]
escachoo	nome masculino	es|ca|[cho]|o
escachouçar	verbo	es|ca|chou|[çar]
escacilho	nome masculino	es|ca|[ci]|lho
escaço	nome masculino	es|[ca]|ço
escada	nome feminino	es|[ca]|da
escadão	nome masculino	es|ca|[dão]
escadaria	nome feminino	es|ca|da|[ri]|a
escádea	nome feminino	es|[cá]|de|a
escadeado	adjetivo	es|ca|de|[a]|do
escadear	verbo	es|ca|de|[ar]
escadeirão	nome masculino	es|ca|dei|[rão]
escadeirar	verbo	es|ca|dei|[rar]
