foragida	nome feminino	fo|ra|[gi]|da
foragido	adjetivo	fo|ra|[gi]|do
foragido	nome masculino	fo|ra|[gi]|do
foragir	verbo	fo|ra|[gir]
foral	nome masculino	fo|[ral]
foraleiro	adjetivo	fo|ra|[lei]|ro
foralengo	adjetivo	fo|ra|[len]|go
forame	nome masculino	fo|[ra]|me
forâmen	nome masculino	fo|[râ]|men
foraminífero	nome masculino	fo|ra|mi|[ní]|fe|ro
foraminoso	adjetivo	fo|ra|mi|[no]|so
foramontão	adjetivo	fo|ra|mon|[tão]
foramontão	nome masculino	fo|ra|mon|[tão]
forâneo	adjetivo	fo|[râ]|ne|o
forântio	nome masculino	fo|[rân]|ti|o
foranto	nome masculino	fo|[ran]|to
forasteira	nome feminino	fo|ras|[tei]|ra
forasteirismo	nome masculino	fo|ras|tei|[ris]|mo
forasteiro	adjetivo	fo|ras|[tei]|ro
forasteiro	nome masculino	fo|ras|[tei]|ro
forata	nome feminino	fo|[ra]|ta
forca	nome feminino	[for]|ca
força	nome feminino	[for]|ça
forcacha	nome feminino	for|[ca]|cha
forcada	nome feminino	for|[ca]|da
forçadamente	advérbio	for|ça|da|[men]|te
forcadela	nome feminino	for|ca|[de]|la
forçado	adjetivo	for|[ça]|do
forcado	nome masculino	for|[ca]|do
forçado	nome masculino	for|[ça]|do
forçador	nome masculino	for|ça|[dor]
forcadura	nome feminino	for|ca|[du]|ra
forcagem	nome feminino	for|[ca]|gem
forcalha	nome feminino	for|[ca]|lha
forçamento	nome masculino	for|ça|[men]|to
forçante	adjetivo	for|[çan]|te
forção	nome masculino	for|[ção]
forcão	nome masculino	for|[cão]
forçar	verbo	for|[çar]
forcar	verbo	for|[car]
forçável	adjetivo	for|[çá]|vel
forcaz	nome masculino	for|[caz]
forcejar	verbo	for|ce|[jar]
forcejo	nome masculino	for|[ce]|jo
fórceps	nome masculino	[fór]|ceps
forcing	nome masculino	[for]|cing
fórcipe	nome masculino	[fór]|ci|pe
forcipressão	nome feminino	for|ci|pres|[são]
forçosamente	advérbio	for|ço|sa|[men]|te
forçoso	adjetivo	for|[ço]|so
forçudo	adjetivo	for|[çu]|do
forçura	nome feminino	for|[çu]|ra
fordicídio	nome masculino	for|di|[cí]|di|o
fordo	adjetivo	[for]|do
forécio	adjetivo	fo|[ré]|ci|o
forécio	nome masculino	fo|[ré]|ci|o
foreira	nome feminino	fo|[rei]|ra
foreiro	nome masculino	fo|[rei]|ro
foreiro	adjetivo	fo|[rei]|ro
forense	adjetivo	fo|[ren]|se
forentano	adjetivo	fo|ren|[ta]|no
forentano	nome masculino	fo|ren|[ta]|no
forfalha	nome feminino	for|[fa]|lha
fórfex	nome masculino	[fór]|fex
fórfice	nome masculino	[fór]|fi|ce
forfícula	nome feminino	for|[fí]|cu|la
forficulário	nome masculino	for|fi|cu|[lá]|ri|o
forficúlida	nome masculino	for|fi|[cú]|li|da
forficulídeo	nome masculino	for|fi|cu|[lí]|de|o
forficulídeo	nome masculino	for|fi|cu|[lí]|de|o
forficulídeo	adjetivo	for|fi|cu|[lí]|de|o
forgalha	nome feminino	for|[ga]|lha
forint	nome masculino	fo|rint
forja	nome feminino	[for]|ja
forjado	adjetivo	for|[ja]|do
forjador	adjetivo	for|ja|[dor]
forjador	nome masculino	for|ja|[dor]
forjadora	nome feminino	for|ja|[do]|ra
forjadura	nome feminino	for|ja|[du]|ra
forjamento	nome masculino	for|ja|[men]|to
forjar	verbo	for|[jar]
forjável	adjetivo	for|[já]|vel
forjicador	adjetivo	for|ji|ca|[dor]
forjicador	nome masculino	for|ji|ca|[dor]
forjicar	verbo	for|ji|[car]
fôrma	nome feminino	[fôr]|ma
forma	nome feminino	[for]|ma
forma-sonata	nome feminino	for|ma-so|[na]|ta
forma-torta	nome masculino	for|ma-tor|ta
forma-torta	nome feminino	for|ma-tor|ta
formação	nome feminino	for|ma|[ção]
formado	adjetivo	for|[ma]|do
formado	nome masculino	for|[ma]|do
formador	adjetivo	for|ma|[dor]
formador	nome masculino	for|ma|[dor]
formadora	nome feminino	for|ma|[do]|ra
formadura	nome feminino	for|ma|[du]|ra
formal	nome masculino	for|[mal]
formal	adjetivo	for|[mal]
formaldeído	nome masculino	for|mal|de|[í]|do
