surriar	verbo	sur|ri|[ar]
surriba	nome feminino	sur|[ri]|ba
surribar	verbo	sur|ri|[bar]
surrinense	adjetivo	sur|ri|[nen]|se
surrinense	nome masculino	sur|ri|[nen]|se
surrinense	nome feminino	sur|ri|[nen]|se
surriola	nome feminino	sur|ri|[o]|la
surripiagem	nome feminino	sur|ri|pi|[a]|gem
surripianço	nome masculino	sur|ri|pi|[an]|ço
surripiar	verbo	sur|ri|pi|[ar]
surripilhar	verbo	sur|ri|pi|[lhar]
surro	nome masculino	[sur]|ro
surrobeco	nome masculino	sur|ro|[be]|co
surrolho	nome masculino	sur|[ro]|lho
surtida	nome feminino	sur|[ti]|da
surtir	verbo	sur|[tir]
surto	adjetivo	[sur]|to
surto	nome masculino	[sur]|to
surtum	nome masculino	sur|[tum]
suru	adjetivo	su|[ru]
suruanã	nome feminino	su|ru|a|[nã]
suruba	adjetivo	su|[ru]|ba
suruba	nome feminino	su|[ru]|ba
surubada	nome feminino	su|ru|[ba]|da
surubi	nome masculino	su|ru|[bi]
surubim	nome masculino	su|ru|[bim]
surucuá	nome masculino	su|ru|cu|[á]
surucucu	nome feminino	su|ru|cu|[cu]
surucucurana	nome feminino	su|ru|cu|cu|[ra]|na
surucucutinga	nome feminino	su|ru|cu|cu|[tin]|ga
suruê	nome masculino	su|ru|[ê]
surulina	nome feminino	su|ru|[li]|na
suruma	nome feminino	su|[ru]|ma
surunganga	adjetivo	su|run|[gan]|ga
surungo	nome masculino	su|[run]|go
surupango	nome masculino	su|ru|[pan]|go
sururgião	nome masculino	su|rur|gi|[ão]
sururina	nome feminino	su|ru|[ri]|na
sururu	nome masculino	su|ru|[ru]
sururuca	nome feminino	su|ru|[ru]|ca
sururucar	verbo	su|ru|ru|[car]
sururucujá	nome feminino	su|ru|ru|cu|[já]
sus	interjeição	[sus]
susalpim	nome masculino	su|sal|[pim]
susana	nome feminino	su|[sa]|na
susano	adjetivo	su|[sa]|no
susão	adjetivo	su|[são]
susceção	nome feminino	sus|ce|[ção]
susceptância	nome feminino	sus|cep|[tân]|ci|a
susceptibilidade	nome feminino	sus|cep|ti|bi|li|[da]|de
susceptibilizar	verbo	sus|cep|ti|bi|li|[zar]
susceptível	nome masculino	sus|cep|[tí]|vel
susceptível	adjetivo	sus|cep|[tí]|vel
susceptível	nome feminino	sus|cep|[tí]|vel
susceptor	nome masculino	sus|cep|[tor]
suscetibilidade	nome feminino	sus|ce|ti|bi|li|[da]|de
suscetibilizar	verbo	sus|ce|ti|bi|li|[zar]
suscetível	adjetivo	sus|ce|[tí]|vel
suscetível	nome masculino	sus|ce|[tí]|vel
suscetível	nome feminino	sus|ce|[tí]|vel
suscitação	nome feminino	sus|ci|ta|[ção]
suscitador	adjetivo	sus|ci|ta|[dor]
suscitador	nome masculino	sus|ci|ta|[dor]
suscitadora	nome feminino	sus|ci|ta|[do]|ra
suscitamento	nome masculino	sus|ci|ta|[men]|to
suscitante	adjetivo	sus|ci|[tan]|te
suscitar	verbo	sus|ci|[tar]
suscitável	adjetivo	sus|ci|[tá]|vel
suserana	nome feminino	su|se|[ra]|na
suserania	nome feminino	su|se|ra|[ni]|a
suserano	nome masculino	su|se|[ra]|no
suserano	adjetivo	su|se|[ra]|no
sushi	nome masculino	sus|[hi]
susiano	adjetivo	su|si|[a]|no
susiano	nome masculino	su|si|[a]|no
súsino	nome masculino	[sú]|si|no
súsino	adjetivo	[sú]|si|no
súsio	adjetivo	[sú]|si|o
súsio	nome masculino	[sú]|si|o
suso	advérbio	[su]|so
susodito	adjetivo	su|so|[di]|to
suspeição	nome feminino	sus|pei|[ção]
suspeita	nome feminino	sus|[pei]|ta
suspeitabilidade	nome feminino	sus|pei|ta|bi|li|[da]|de
suspeitador	adjetivo	sus|pei|ta|[dor]
suspeitador	nome masculino	sus|pei|ta|[dor]
suspeitante	adjetivo	sus|pei|[tan]|te
suspeitar	verbo	sus|pei|[tar]
suspeitável	adjetivo	sus|pei|[tá]|vel
suspeito	adjetivo	sus|[pei]|to
suspeito	nome masculino	sus|[pei]|to
suspeitosamente	advérbio	sus|pei|to|sa|[men]|te
suspeitosidade	nome feminino	sus|pei|to|si|[da]|de
suspeitoso	adjetivo	sus|pei|[to]|so
suspender	verbo	sus|pen|[der]
suspêndio	nome masculino	sus|[pên]|di|o
suspensão	nome feminino	sus|pen|[são]
suspense	nome masculino	sus|[pen]|se
suspensivo	adjetivo	sus|pen|[si]|vo
suspenso	adjetivo	sus|[pen]|so
