sitídeo	nome masculino	si|[tí]|de|o
sitídeo	adjetivo	si|[tí]|de|o
sitídeo	nome masculino	si|[tí]|de|o
sítio	nome masculino	[sí]|ti|o
sitioca	nome feminino	si|ti|[o]|ca
sitiofobia	nome feminino	si|ti|o|fo|[bi]|a
sitiófobo	adjetivo	si|ti|[ó]|fo|bo
sitiófobo	nome masculino	si|ti|[ó]|fo|bo
sitiologia	nome feminino	si|ti|o|lo|[gi]|a
sitiológico	adjetivo	si|ti|o|[ló]|gi|co
sitiomania	nome feminino	si|ti|o|ma|[ni]|a
sitioterapia	nome feminino	si|ti|o|te|ra|[pi]|a
sito	adjetivo	[si]|to
sito	nome masculino	[si]|to
sitófago	adjetivo	si|[tó]|fa|go
sitófago	nome masculino	si|[tó]|fa|go
sitofílace	nome masculino	si|to|[fí]|la|ce
sitófilo	nome masculino	si|[tó]|fi|lo
sitofobia	nome feminino	si|to|fo|[bi]|a
sitófobo	adjetivo	si|[tó]|fo|bo
sitófobo	nome masculino	si|[tó]|fo|bo
sitologia	nome feminino	si|to|lo|[gi]|a
sitológico	adjetivo	si|to|[ló]|gi|co
sitomania	nome feminino	si|to|ma|[ni]|a
sitomaníaco	adjetivo	si|to|ma|[ní]|a|co
sitomaníaco	nome masculino	si|to|ma|[ní]|a|co
sitómano	nome masculino	si|[tó]|ma|no
sitômano	nome masculino	si|[tô]|ma|no
sitómetro	nome masculino	si|[tó]|me|tro
sitômetro	nome masculino	si|[tô]|me|tro
sitona	nome masculino	si|[to]|na
sítone	adjetivo	[sí]|to|ne
sítone	nome masculino	[sí]|to|ne
sítone	nome feminino	[sí]|to|ne
sitônio	adjetivo	si|[tô]|ni|o
sitônio	nome masculino	si|[tô]|ni|o
sitónio	adjetivo	si|[tó]|ni|o
sitónio	nome masculino	si|[tó]|ni|o
sitotoxismo	nome masculino	si|to|to|[xis]|mo
situação	nome feminino	si|tu|a|[ção]
situacionismo	nome masculino	si|tu|a|ci|o|[nis]|mo
situacionista	nome masculino	si|tu|a|ci|o|[nis]|ta
situacionista	adjetivo	si|tu|a|ci|o|[nis]|ta
situacionista	nome feminino	si|tu|a|ci|o|[nis]|ta
situacionístico	adjetivo	si|tu|a|ci|o|[nís]|ti|co
situar	verbo	si|tu|[ar]
situável	adjetivo	si|tu|[á]|vel
sítula	nome feminino	[sí]|tu|la
siurai	nome masculino	siu|[rai]
siva	nome feminino	[si]|va
sivale	nome masculino	si|[va]|le
sivale	nome feminino	si|[va]|le
sivane	nome feminino	si|[va]|ne
sivatério	nome masculino	si|va|[té]|ri|o
sixties	nome masculino	six|ties
sizetese	nome feminino	si|ze|[te]|se
sizígia	nome feminino	si|[zí]|gi|a
sizígio	nome masculino	si|[zí]|gi|o
ska	adjetivo	[ska]
skate	nome masculino	[ska]|te
sketch	nome masculino	[sketch]
ski	nome masculino	[ski]
skidaviano	adjetivo	ski|da|vi|[a]|no
skiff	nome masculino	[skiff]
skin	nome masculino	[skin]
skinhead	nome masculino	skin|head
skinhead	nome feminino	skin|head
skipper	nome masculino	skip|per
slalom	nome masculino	[sla]|lom
slang	nome masculino	[slang]
slick	nome masculino	[slick]
slide	nome masculino	[sli]|de
slip	nome masculino	[slip]
slogan	nome masculino	[slo]|gan
slow	nome masculino	[slow]
smash	nome masculino	[smash]
smithsonita	nome feminino	smith|so|[ni]|ta
smithsonite	nome feminino	smith|so|[ni]|te
smog	nome masculino	[smog]
smoking	nome masculino	[smo]|king
smorzando	advérbio	smor|zan|do
snack	nome masculino	[snack]
snack-bar	nome masculino	[snack-bar]
sniper	nome masculino	[sni]|per
sniper	nome feminino	[sni]|per
snob	adjetivo	[snob]
snob	nome masculino	[snob]
snob	nome feminino	[snob]
snooker	nome masculino	snoo|ker
snowboard	nome masculino	snow|board
só	adjetivo	[só]
só	advérbio	[só]
só	nome masculino	[só]
sô	nome masculino	[sô]
soá-soá	nome masculino	so|á-so|[á]
soaberto	adjetivo	so|a|[ber]|to
soabrir	verbo	so|a|[brir]
soada	nome feminino	so|[a]|da
soado	adjetivo	so|[a]|do
soagem	nome feminino	so|[a]|gem
