tourão-do-mato	nome masculino	tou|rão-do-ma|to
tourar	verbo	tou|[rar]
touraria	nome feminino	tou|ra|[ri]|a
toureador	adjetivo	tou|re|a|[dor]
toureador	nome masculino	tou|re|a|[dor]
toureanda	adjetivo	tou|re|[an]|da
tourear	verbo	tou|re|[ar]
toureio	nome masculino	tou|[rei]|o
toureira	nome feminino	tou|[rei]|ra
toureiro	nome masculino	tou|[rei]|ro
toureiro	adjetivo	tou|[rei]|ro
tourejão	nome masculino	tou|re|[jão]
tourejar	verbo	tou|re|[jar]
touriga	nome feminino	tou|[ri]|ga
tourigão	nome masculino	tou|ri|[gão]
tourigo	nome masculino	tou|[ri]|go
touril	nome masculino	tou|[ril]
tourinha	nome feminino	tou|[ri]|nha
tourista	nome masculino	tou|[ris]|ta
tournée	nome feminino	tour|née
touro	nome masculino	[tou]|ro
touro-galego	nome masculino	tou|ro-ga|[le]|go
touro-paul	nome masculino	tou|ro-pa|[ul]
touruno	adjetivo	tou|[ru]|no
touta	nome feminino	[tou]|ta
touteador	adjetivo	tou|te|a|[dor]
touteador	nome masculino	tou|te|a|[dor]
toutear	verbo	tou|te|[ar]
toutelo	nome masculino	tou|[te]|lo
toutiçada	nome feminino	tou|ti|[ça]|da
toutiço	nome masculino	tou|[ti]|ço
toutinegra	nome feminino	tou|ti|[ne]|gra
toutivanas	nome masculino	tou|ti|[va]|nas
toutivanas	nome feminino	tou|ti|[va]|nas
tovaca	nome feminino	to|[va]|ca
tovacaçu	nome feminino	to|va|ca|[çu]
továria	nome feminino	to|[vá]|ri|a
tovetove	nome masculino	to|ve|[to]|ve
toxandro	adjetivo	to|[xan]|dro
toxandro	nome masculino	to|[xan]|dro
toxemia	nome feminino	to|xe|[mi]|a
toxémico	adjetivo	to|[xé]|mi|co
toxêmico	adjetivo	to|[xê]|mi|co
toxicar	verbo	to|xi|[car]
toxicemia	nome feminino	to|xi|ce|[mi]|a
toxicémico	adjetivo	to|xi|[cé]|mi|co
toxicêmico	adjetivo	to|xi|[cê]|mi|co
toxicidade	nome feminino	to|xi|ci|[da]|de
tóxico	adjetivo	[tó]|xi|co
tóxico	nome masculino	[tó]|xi|co
toxicodendro	nome masculino	to|xi|co|[den]|dro
toxicodependência	nome feminino	to|xi|co|de|pen|[dên]|ci|a
toxicodependente	adjetivo	to|xi|co|de|pen|[den]|te
toxicodependente	nome masculino	to|xi|co|de|pen|[den]|te
toxicodependente	nome feminino	to|xi|co|de|pen|[den]|te
toxicofagia	nome feminino	to|xi|co|fa|[gi]|a
toxicófago	nome masculino	to|xi|[có]|fa|go
toxicofilia	nome feminino	to|xi|co|fi|[li]|a
toxicófilo	adjetivo	to|xi|[có]|fi|lo
toxicófilo	nome masculino	to|xi|[có]|fi|lo
toxicofobia	nome feminino	to|xi|co|fo|[bi]|a
toxicófobo	adjetivo	to|xi|[có]|fo|bo
toxicófobo	nome masculino	to|xi|[có]|fo|bo
toxicóforo	adjetivo	to|xi|[có]|fo|ro
toxicógeno	adjetivo	to|xi|[có]|ge|no
toxicografia	nome feminino	to|xi|co|gra|[fi]|a
toxicográfico	adjetivo	to|xi|co|[grá]|fi|co
toxicoide	adjetivo	to|xi|[coi]|de
toxicóloga	nome feminino	to|xi|[có]|lo|ga
toxicologia	nome feminino	to|xi|co|lo|[gi]|a
toxicológico	adjetivo	to|xi|co|[ló]|gi|co
toxicologista	nome masculino	to|xi|co|lo|[gis]|ta
toxicologista	nome feminino	to|xi|co|lo|[gis]|ta
toxicólogo	nome masculino	to|xi|[có]|lo|go
toxicómana	nome feminino	to|xi|[có]|ma|na
toxicomania	nome feminino	to|xi|co|ma|[ni]|a
toxicomaníaca	nome feminino	to|xi|co|ma|[ní]|a|ca
toxicomaníaco	adjetivo	to|xi|co|ma|[ní]|a|co
toxicomaníaco	nome masculino	to|xi|co|ma|[ní]|a|co
toxicómano	adjetivo	to|xi|[có]|ma|no
toxicómano	nome masculino	to|xi|[có]|ma|no
toxicômano	adjetivo	to|xi|[cô]|ma|no
toxicômano	nome masculino	to|xi|[cô]|ma|no
toxicométrico	adjetivo	to|xi|co|[mé]|tri|co
toxicómetro	nome masculino	to|xi|[có]|me|tro
toxicômetro	nome masculino	to|xi|[cô]|me|tro
toxicopatia	nome feminino	to|xi|co|pa|[ti]|a
toxicose	nome feminino	to|xi|[co]|se
toxicotraficante	nome masculino	to|xi|co|tra|fi|[can]|te
toxicotraficante	nome feminino	to|xi|co|tra|fi|[can]|te
toxicotráfico	nome masculino	to|xi|co|[trá]|fi|co
toxidade	nome feminino	to|xi|[da]|de
toxidermia	nome feminino	to|xi|der|[mi]|a
toxidérmico	adjetivo	to|xi|[dér]|mi|co
toxígeno	adjetivo	to|[xí]|ge|no
toxina	nome feminino	to|[xi]|na
toxinicida	adjetivo	to|xi|ni|[ci]|da
toxinose	nome feminino	to|xi|[no]|se
toxiterapia	nome feminino	to|xi|te|ra|[pi]|a
toxiterápico	adjetivo	to|xi|te|[rá]|pi|co
