traspassável	adjetivo	tras|pas|[sá]|vel
traspasse	nome masculino	tras|[pas]|se
traspasso	nome masculino	tras|[pas]|so
traspés	nome masculino	tras|[pés]
traspilar	nome masculino	tras|pi|[lar]
traspor	verbo	tras|[por]
trastada	nome feminino	tras|[ta]|da
trastagano	adjetivo	tras|ta|[ga]|no
trastalhada	nome feminino	tras|ta|[lha]|da
trastalhão	nome masculino	tras|ta|[lhão]
trastalhona	nome feminino	tras|ta|[lho]|na
trastaria	nome feminino	tras|ta|[ri]|a
traste	nome masculino	[tras]|te
trastear	verbo	tras|te|[ar]
trasteio	nome masculino	tras|[tei]|o
trastejador	adjetivo	tras|te|ja|[dor]
trastejador	nome masculino	tras|te|ja|[dor]
trastejamento	nome masculino	tras|te|ja|[men]|to
trastejão	nome masculino	tras|te|[jão]
trastejar	verbo	tras|te|[jar]
trastempar	verbo	tras|tem|[par]
trastempo	nome masculino	tras|[tem]|po
trasto	nome masculino	[tras]|to
trastornar	verbo	tras|tor|[nar]
trasunto	nome masculino	tra|[sun]|to
trasvazar	verbo	tras|va|[zar]
trasvestir	verbo	tras|ves|[tir]
trasviar	verbo	tras|vi|[ar]
trasvio	nome masculino	tras|[vi]|o
trasvisto	adjetivo	tras|[vis]|to
trasvoltear	verbo	tras|vol|te|[ar]
tratada	nome feminino	tra|[ta]|da
tratadeira	nome feminino	tra|ta|[dei]|ra
tratadista	nome masculino	tra|ta|[dis]|ta
tratadista	nome feminino	tra|ta|[dis]|ta
tratadístico	adjetivo	tra|ta|[dís]|ti|co
tratado	adjetivo	tra|[ta]|do
tratado	nome masculino	tra|[ta]|do
tratador	adjetivo	tra|ta|[dor]
tratador	nome masculino	tra|ta|[dor]
tratadora	nome feminino	tra|ta|[do]|ra
tratamento	nome masculino	tra|ta|[men]|to
tratantada	nome feminino	tra|tan|[ta]|da
tratante	adjetivo	tra|[tan]|te
tratante	nome masculino	tra|[tan]|te
tratante	nome feminino	tra|[tan]|te
tratantear	verbo	tra|tan|te|[ar]
tratantice	nome feminino	tra|tan|[ti]|ce
tratantório	nome masculino	tra|tan|[tó]|ri|o
tratar	verbo	tra|[tar]
tratável	adjetivo	tra|[tá]|vel
tratavelmente	advérbio	tra|ta|vel|[men]|te
trateador	adjetivo	tra|te|a|[dor]
trateador	nome masculino	tra|te|a|[dor]
tratear	verbo	tra|te|[ar]
tratista	adjetivo	tra|[tis]|ta
tratista	nome masculino	tra|[tis]|ta
tratista	nome feminino	tra|[tis]|ta
trato	nome masculino	[tra]|to
tratocarro	nome masculino	tra|to|[car]|ro
trator	adjetivo	tra|[tor]
trator	nome masculino	tra|[tor]
tratório	adjetivo	tra|[tó]|ri|o
tratorista	nome masculino	tra|to|[ris]|ta
tratorista	nome feminino	tra|to|[ris]|ta
traulitada	nome feminino	trau|li|[ta]|da
traulitar	verbo	trau|li|[tar]
trauliteiro	nome masculino	trau|li|[tei]|ro
trauliteiro	adjetivo	trau|li|[tei]|ro
traulito	nome masculino	trau|[li]|to
trauma	nome masculino	[trau]|ma
traumaticamente	advérbio	trau|ma|ti|ca|[men]|te
traumaticidade	nome feminino	trau|ma|ti|ci|[da]|de
traumaticina	nome feminino	trau|ma|ti|[ci]|na
traumático	adjetivo	trau|[má]|ti|co
traumatismo	nome masculino	trau|ma|[tis]|mo
traumatização	nome feminino	trau|ma|ti|za|[ção]
traumatizada	nome feminino	trau|ma|ti|[za]|da
traumatizado	nome masculino	trau|ma|ti|[za]|do
traumatizado	adjetivo	trau|ma|ti|[za]|do
traumatizante	adjetivo	trau|ma|ti|[zan]|te
traumatizar	verbo	trau|ma|ti|[zar]
traumatologia	nome feminino	trau|ma|to|lo|[gi]|a
traumatológico	adjetivo	trau|ma|to|[ló]|gi|co
traumatopneia	nome feminino	trau|ma|top|[nei]|a
traumatopneico	adjetivo	trau|ma|top|[nei]|co
tráupida	nome masculino	[tráu]|pi|da
traupídeo	nome masculino	trau|[pí]|de|o
traupídeo	adjetivo	trau|[pí]|de|o
trauso	adjetivo	[trau]|so
trauso	nome masculino	[trau]|so
trauta	nome feminino	[trau]|ta
trautear	verbo	trau|te|[ar]
trauteio	nome masculino	trau|[tei]|o
trava	nome feminino	[tra]|va
trava-contas	nome masculino	tra|va-con|tas
trava-língua	nome masculino	tra|va-lín|gua
travação	nome feminino	tra|va|[ção]
travada	nome feminino	tra|[va]|da
travadamente	advérbio	tra|va|da|[men]|te
