hidroterapêutico	adjetivo	hi|dro|te|ra|[pêu]|ti|co
hidroterapia	nome feminino	hi|dro|te|ra|[pi]|a
hidroterápico	adjetivo	hi|dro|te|[rá]|pi|co
hidrotermal	adjetivo	hi|dro|ter|[mal]
hidrotérmico	adjetivo	hi|dro|[tér]|mi|co
hidrotia	nome feminino	hi|dro|[ti]|a
hidrótica	nome feminino	hi|[dró]|ti|ca
hidrótico	adjetivo	hi|[dró]|ti|co
hidrotimetria	nome feminino	hi|dro|ti|me|[tri]|a
hidrotimétrico	adjetivo	hi|dro|ti|[mé]|tri|co
hidrotímetro	nome masculino	hi|dro|[tí]|me|tro
hidrotipia	nome feminino	hi|dro|ti|[pi]|a
hidrotípico	adjetivo	hi|dro|[tí]|pi|co
hidrotomia	nome feminino	hi|dro|to|[mi]|a
hidrotômico	adjetivo	hi|dro|[tô]|mi|co
hidrotómico	adjetivo	hi|dro|[tó]|mi|co
hidrotórax	nome masculino	hi|dro|[tó]|rax
hidrotrópico	adjetivo	hi|dro|[tró]|pi|co
hidrotropismo	nome masculino	hi|dro|tro|[pis]|mo
hidrovia	nome feminino	hi|dro|[vi]|a
hidroviário	adjetivo	hi|dro|vi|[á]|ri|o
hidróxido	nome masculino	hi|[dró]|xi|do
hidroxilamina	nome feminino	hi|dro|xi|la|[mi]|na
hidroxilião	nome masculino	hi|dro|xi|li|[ão]
hidroxilo	nome masculino	hi|dro|[xi]|lo
hidrozincite	nome feminino	hi|dro|zin|[ci]|te
hidrozoário	nome masculino	hi|dro|zo|[á]|ri|o
hidrozoário	adjetivo	hi|dro|zo|[á]|ri|o
hidruntino	adjetivo	hi|drun|[ti]|no
hidruntino	nome masculino	hi|drun|[ti]|no
hidrúria	nome feminino	hi|[drú]|ri|a
hidrúrico	adjetivo	hi|[drú]|ri|co
hidrúrico	nome masculino	hi|[drú]|ri|co
hiemação	nome feminino	hi|e|ma|[ção]
hiemal	adjetivo	hi|e|[mal]
hiena	nome feminino	hi|[e]|na
hiénida	nome masculino	hi|[é]|ni|da
hiênida	nome masculino	hi|[ê]|ni|da
hienídeo	adjetivo	hi|e|[ní]|de|o
hienídeo	nome masculino	hi|e|[ní]|de|o
hienídeo	nome masculino	hi|e|[ní]|de|o
hierácio	nome masculino	hi|e|[rá]|ci|o
hieracite	nome feminino	hi|e|ra|[ci]|te
hierapolitano	adjetivo	hi|e|ra|po|li|[ta]|no
hierapolitano	nome masculino	hi|e|ra|po|li|[ta]|no
hierarca	nome masculino	hi|e|[rar]|ca
hierarquia	nome feminino	hi|e|rar|[qui]|a
hierarquicamente	advérbio	hi|e|rar|qui|ca|[men]|te
hierárquico	adjetivo	hi|e|[rár]|qui|co
hierarquismo	nome masculino	hi|e|rar|[quis]|mo
hierarquização	nome feminino	hi|e|rar|qui|za|[ção]
hierarquizado	adjetivo	hi|e|rar|qui|[za]|do
hierarquizante	adjetivo	hi|e|rar|qui|[zan]|te
hierarquizar	verbo	hi|e|rar|qui|[zar]
hierarquizável	adjetivo	hi|e|rar|qui|[zá]|vel
hierática	nome feminino	hi|e|[rá]|ti|ca
hieraticamente	advérbio	hi|e|ra|ti|ca|[men]|te
hierático	adjetivo	hi|e|[rá]|ti|co
hieratismo	nome masculino	hi|e|ra|[tis]|mo
hieratizar	verbo	hi|e|ra|ti|[zar]
hierocracia	nome feminino	hi|e|ro|cra|[ci]|a
hierodrama	nome masculino	hi|e|ro|[dra]|ma
hierodramático	adjetivo	hi|e|ro|dra|[má]|ti|co
hierodulia	nome feminino	hi|e|ro|du|[li]|a
hierodulo	nome masculino	hi|e|ro|[du]|lo
hierofanta	nome masculino	hi|e|ro|[fan]|ta
hierofante	nome masculino	hi|e|ro|[fan]|te
hierofântico	adjetivo	hi|e|ro|[fân]|ti|co
hierofântide	nome feminino	hi|e|ro|[fân]|ti|de
hierogeografia	nome feminino	hi|e|ro|ge|o|gra|[fi]|a
hieroglífica	nome feminino	hi|e|ro|[glí]|fi|ca
hieroglífico	adjetivo	hi|e|ro|[glí]|fi|co
hieróglifo	nome masculino	hi|e|[ró]|gli|fo
hierografia	nome feminino	hi|e|ro|gra|[fi]|a
hierográfico	adjetivo	hi|e|ro|[grá]|fi|co
hierógrafo	nome masculino	hi|e|[ró]|gra|fo
hierograma	nome masculino	hi|e|ro|[gra]|ma
hierogramático	adjetivo	hi|e|ro|gra|[má]|ti|co
hierogramatista	nome masculino	hi|e|ro|gra|ma|[tis]|ta
hierologia	nome feminino	hi|e|ro|lo|[gi]|a
hierológico	adjetivo	hi|e|ro|[ló]|gi|co
hierólogo	nome masculino	hi|e|[ró]|lo|go
hieromancia	nome feminino	hi|e|ro|man|[ci]|a
hieromante	nome masculino	hi|e|ro|[man]|te
hieromante	nome feminino	hi|e|ro|[man]|te
hieromântico	adjetivo	hi|e|ro|[mân]|ti|co
hieromnémone	nome masculino	hi|e|rom|[né]|mo|ne
hieromnêmone	nome masculino	hi|e|rom|[nê]|mo|ne
hieronica	nome masculino	hi|e|ro|[ni]|ca
hierônico	adjetivo	hi|e|[rô]|ni|co
hierónico	adjetivo	hi|e|[ró]|ni|co
hieronímia	nome feminino	hi|e|ro|[ní]|mi|a
hieronímico	adjetivo	hi|e|ro|[ní]|mi|co
hieronimita	nome masculino	hi|e|ro|ni|[mi]|ta
hieronimita	nome feminino	hi|e|ro|ni|[mi]|ta
hierônimo	nome masculino	hi|e|[rô]|ni|mo
hierónimo	nome masculino	hi|e|[ró]|ni|mo
hieropeu	nome masculino	hi|e|ro|[peu]
hieroscopia	nome feminino	hi|e|ros|co|[pi]|a
hieroscópico	adjetivo	hi|e|ros|[có]|pi|co
