helicoide	nome masculino	he|li|[coi]|de
helicométrico	adjetivo	he|li|co|[mé]|tri|co
helicómetro	nome masculino	he|li|[có]|me|tro
helicômetro	nome masculino	he|li|[cô]|me|tro
helicónia	nome feminino	he|li|[có]|ni|a
helicônia	nome feminino	he|li|[cô]|ni|a
heliconiano	adjetivo	he|li|co|ni|[a]|no
helicónio	adjetivo	he|li|[có]|ni|o
helicônio	adjetivo	he|li|[cô]|ni|o
helicópode	adjetivo	he|li|[có]|po|de
helicóptero	nome masculino	he|li|[cóp]|te|ro
helicóstego	nome masculino	he|li|[cós]|te|go
helicotrema	nome masculino	he|li|co|[tre]|ma
helicriso	nome masculino	he|li|[cri]|so
helícula	nome feminino	he|[lí]|cu|la
heligolandês	adjetivo	he|li|go|lan|[dês]
heligolandês	nome masculino	he|li|go|lan|[dês]
hélio	nome masculino	[hé]|li|o
heliocêntrico	adjetivo	he|li|o|[cên]|tri|co
heliocentrismo	nome masculino	he|li|o|cen|[tris]|mo
heliocometa	nome masculino	he|li|o|co|[me]|ta
heliocromia	nome feminino	he|li|o|cro|[mi]|a
heliocrômico	adjetivo	he|li|o|[crô]|mi|co
heliocrómico	adjetivo	he|li|o|[cró]|mi|co
heliodinâmica	nome feminino	he|li|o|di|[nâ]|mi|ca
heliodinâmico	adjetivo	he|li|o|di|[nâ]|mi|co
heliodinâmico	nome masculino	he|li|o|di|[nâ]|mi|co
heliofânio	nome masculino	he|li|o|[fâ]|ni|o
heliófila	nome feminino	he|li|[ó]|fi|la
heliofílea	nome feminino	he|li|o|[fí]|le|a
heliofilia	nome feminino	he|li|o|fi|[li]|a
heliófilo	adjetivo	he|li|[ó]|fi|lo
heliófilo	nome masculino	he|li|[ó]|fi|lo
heliófito	nome masculino	he|li|[ó]|fi|to
heliofobia	nome feminino	he|li|o|fo|[bi]|a
heliófobo	adjetivo	he|li|[ó]|fo|bo
heliófobo	nome masculino	he|li|[ó]|fo|bo
heliofotométrico	adjetivo	he|li|o|fo|to|[mé]|tri|co
heliofotômetro	nome masculino	he|li|o|fo|[tô]|me|tro
heliofotómetro	nome masculino	he|li|o|fo|[tó]|me|tro
heliófugo	adjetivo	he|li|[ó]|fu|go
heliogabálico	adjetivo	he|li|o|ga|[bá]|li|co
heliógeno	adjetivo	he|li|[ó]|ge|no
heliografia	nome feminino	he|li|o|gra|[fi]|a
heliográfico	adjetivo	he|li|o|[grá]|fi|co
heliógrafo	nome masculino	he|li|[ó]|gra|fo
heliogravador	adjetivo	he|li|o|gra|va|[dor]
heliogravador	nome masculino	he|li|o|gra|va|[dor]
heliogravura	nome feminino	he|li|o|gra|[vu]|ra
heliólatra	adjetivo	he|li|[ó]|la|tra
heliólatra	nome masculino	he|li|[ó]|la|tra
heliólatra	nome feminino	he|li|[ó]|la|tra
heliolatria	nome feminino	he|li|o|la|[tri]|a
heliolátrico	adjetivo	he|li|o|[lá]|tri|co
helioloxodromia	nome feminino	he|li|o|lo|xo|dro|[mi]|a
heliomagnetômetro	nome masculino	he|li|o|mag|ne|[tô]|me|tro
heliomagnetómetro	nome masculino	he|li|o|mag|ne|[tó]|me|tro
heliométrico	adjetivo	he|li|o|[mé]|tri|co
heliômetro	nome masculino	he|li|[ô]|me|tro
heliómetro	nome masculino	he|li|[ó]|me|tro
heliomotor	nome masculino	he|li|o|mo|[tor]
helión	nome masculino	he|li|[ón]
heliopatia	nome feminino	he|li|o|pa|[ti]|a
heliopático	adjetivo	he|li|o|[pá]|ti|co
helioplastia	nome feminino	he|li|o|plas|[ti]|a
helioplástico	adjetivo	he|li|o|[plás]|ti|co
heliopolitano	adjetivo	he|li|o|po|li|[ta]|no
heliopolitano	nome masculino	he|li|o|po|li|[ta]|no
helioscopia	nome feminino	he|li|os|co|[pi]|a
helioscópico	adjetivo	he|li|os|[có]|pi|co
helioscópio	nome masculino	he|li|os|[có]|pi|o
heliose	nome feminino	he|li|[o]|se
heliostática	nome feminino	he|li|os|[tá]|ti|ca
heliostático	adjetivo	he|li|os|[tá]|ti|co
helióstato	nome masculino	he|li|[ós]|ta|to
heliotactismo	nome masculino	he|li|o|tac|[tis]|mo
heliotatismo	nome masculino	he|li|o|ta|[tis]|mo
heliotecnia	nome feminino	he|li|o|tec|[ni]|a
heliotécnico	adjetivo	he|li|o|[téc]|ni|co
helioterapia	nome feminino	he|li|o|te|ra|[pi]|a
helioterápico	adjetivo	he|li|o|te|[rá]|pi|co
heliotermométrico	adjetivo	he|li|o|ter|mo|[mé]|tri|co
heliotermômetro	nome masculino	he|li|o|ter|[mô]|me|tro
heliotermómetro	nome masculino	he|li|o|ter|[mó]|me|tro
heliotipia	nome feminino	he|li|o|ti|[pi]|a
heliotípico	adjetivo	he|li|o|[tí]|pi|co
heliótipo	nome masculino	he|li|[ó]|ti|po
heliotropia	nome feminino	he|li|o|tro|[pi]|a
heliotrópico	adjetivo	he|li|o|[tró]|pi|co
heliotropina	nome feminino	he|li|o|tro|[pi]|na
heliotrópio	nome masculino	he|li|o|[tró]|pi|o
heliotropismo	nome masculino	he|li|o|tro|[pis]|mo
heliozoário	nome masculino	he|li|o|zo|[á]|ri|o
heliozoário	adjetivo	he|li|o|zo|[á]|ri|o
heliporto	nome masculino	he|li|[por]|to
heliportuário	adjetivo	he|li|por|tu|[á]|ri|o
helitransportado	adjetivo	he|li|trans|por|[ta]|do
helitransportar	verbo	he|li|trans|por|[tar]
helitransporte	nome masculino	he|li|trans|[por]|te
hélix	nome masculino	[hé]|lix
