oja	nome feminino	[o]|ja
ojeriza	nome feminino	o|je|[ri]|za
ojerizar	verbo	o|je|ri|[zar]
olá	interjeição	o|[lá]
ola	nome feminino	[o]|la
olace	nome masculino	o|[la]|ce
olácea	nome feminino	o|[lá]|ce|a
oláceo	adjetivo	o|[lá]|ce|o
olaeira	nome feminino	o|la|[ei]|ra
olaia	nome feminino	o|[lai]|a
olampi	nome masculino	o|lam|[pi]
olandês	adjetivo	o|lan|[dês]
olandês	nome masculino	o|lan|[dês]
olânico	adjetivo	o|[lâ]|ni|co
olanina	nome feminino	o|la|[ni]|na
olaré	interjeição	o|la|[ré]
olaria	nome feminino	o|la|[ri]|a
olarila	interjeição	o|la|[ri]|la
olarilolé	interjeição	o|la|ri|lo|[lé]
olbiopolitano	adjetivo	ol|bi|o|po|li|[ta]|no
olbiopolitano	nome masculino	ol|bi|o|po|li|[ta]|no
olciniate	adjetivo	ol|ci|ni|[a]|te
olciniate	nome masculino	ol|ci|ni|[a]|te
olciniate	nome feminino	ol|ci|ni|[a]|te
oldembúrgia	nome feminino	ol|dem|[búr]|gi|a
oldemburguês	adjetivo	ol|dem|bur|[guês]
oldemburguês	nome masculino	ol|dem|bur|[guês]
oldenlândia	nome feminino	ol|den|[lân]|di|a
olé	interjeição	o|[lé]
olé	nome masculino	o|[lé]
oleácea	nome feminino	o|le|[á]|ce|a
oleáceo	adjetivo	o|le|[á]|ce|o
oleacidímetro	nome masculino	o|le|a|ci|[dí]|me|tro
oleadar	verbo	o|le|a|[dar]
oleado	nome masculino	o|le|[a]|do
oleado	adjetivo	o|le|[a]|do
oleaginar	verbo	o|le|a|gi|[nar]
oleagíneo	adjetivo	o|le|a|[gí]|ne|o
oleaginosa	nome feminino	o|le|a|gi|[no]|sa
oleaginoso	adjetivo	o|le|a|gi|[no]|so
oleandrina	nome feminino	o|le|an|[dri]|na
oleandro	nome masculino	o|le|[an]|dro
olear	verbo	o|le|[ar]
olearia	nome feminino	o|le|a|[ri]|a
oleastro	nome masculino	o|le|[as]|tro
oleato	nome masculino	o|le|[a]|to
olecraniano	adjetivo	o|le|cra|ni|[a]|no
olecrânio	nome masculino	o|le|[crâ]|ni|o
olecrano	nome masculino	o|le|[cra]|no
oleento	adjetivo	o|le|[en]|to
olefina	nome feminino	o|le|[fi]|na
oleico	adjetivo	o|[lei]|co
oleícola	adjetivo	o|le|[í]|co|la
oleicultor	nome masculino	o|lei|cul|[tor]
oleicultor	adjetivo	o|lei|cul|[tor]
oleicultora	nome feminino	o|lei|cul|[to]|ra
oleicultura	nome feminino	o|lei|cul|[tu]|ra
oleídeo	adjetivo	o|le|[í]|de|o
oleídeo	nome masculino	o|le|[í]|de|o
oleífero	adjetivo	o|le|[í]|fe|ro
oleificante	adjetivo	o|lei|fi|[can]|te
oleifoliado	adjetivo	o|lei|fo|li|[a]|do
oleifólio	adjetivo	o|lei|[fó]|li|o
oleígeno	adjetivo	o|le|[í]|ge|no
oleila	nome feminino	o|[lei]|la
oleína	nome feminino	o|le|[í]|na
oleira	nome feminino	o|[lei]|ra
oleirense	adjetivo	o|lei|[ren]|se
oleirense	nome masculino	o|lei|[ren]|se
oleirense	nome feminino	o|lei|[ren]|se
oleiro	nome masculino	o|[lei]|ro
oleiro	adjetivo	o|[lei]|ro
olenário	adjetivo	o|le|[ná]|ri|o
olência	nome feminino	o|[lên]|ci|a
olente	adjetivo	o|[len]|te
óleo	nome masculino	[ó]|le|o
óleo-barão	nome masculino	ó|le|o-ba|rão
oleoduto	nome masculino	o|le|o|[du]|to
oleogénese	nome feminino	o|le|o|[gé]|ne|se
oleografia	nome feminino	o|le|o|gra|[fi]|a
oleográfico	adjetivo	o|le|o|[grá]|fi|co
oleogravura	nome feminino	o|le|o|gra|[vu]|ra
oleol	nome masculino	o|le|[ol]
oleolado	nome masculino	o|le|o|[la]|do
oleolatado	adjetivo	o|le|o|la|[ta]|do
oleolatado	nome masculino	o|le|o|la|[ta]|do
oleolato	nome masculino	o|le|o|[la]|to
oleólico	adjetivo	o|le|[ó]|li|co
oleolito	nome masculino	o|le|o|[li]|to
oleométrico	adjetivo	o|le|o|[mé]|tri|co
oleômetro	nome masculino	o|le|[ô]|me|tro
oleómetro	nome masculino	o|le|[ó]|me|tro
oleona	nome feminino	o|le|[o]|na
oleorresina	nome feminino	o|le|or|re|[si]|na
oleorresinoso	adjetivo	o|le|or|re|si|[no]|so
oleorricinato	nome masculino	o|le|or|ri|ci|[na]|to
oleorricínico	adjetivo	o|le|or|ri|[cí]|ni|co
oleosidade	nome masculino	o|le|o|si|[da]|de
oleosidade	nome feminino	o|le|o|si|[da]|de
oleoso	adjetivo	o|le|[o]|so
