deificador	nome masculino	dei|fi|ca|[dor]
deificadora	nome feminino	dei|fi|ca|[do]|ra
deificar	verbo	dei|fi|[car]
deífico	adjetivo	de|[í]|fi|co
deiforme	adjetivo	dei|[for]|me
deípara	nome feminino	de|[í]|pa|ra
deiscência	nome feminino	deis|[cên]|ci|a
deiscente	adjetivo	deis|[cen]|te
deísmo	nome masculino	de|[ís]|mo
deísta	adjetivo	de|[ís]|ta
deísta	nome masculino	de|[ís]|ta
deísta	nome feminino	de|[ís]|ta
deístico	adjetivo	de|[ís]|ti|co
deita	nome feminino	[dei]|ta
deita-gatos	nome masculino	dei|ta-ga|tos
deitada	nome feminino	dei|[ta]|da
deitado	adjetivo	dei|[ta]|do
deitado	nome masculino	dei|[ta]|do
deitadura	nome feminino	dei|ta|[du]|ra
deitar	verbo	dei|[tar]
dêitico	adjetivo	[dêi]|ti|co
dêitico	nome masculino	[dêi]|ti|co
deítico	nome masculino	de|[í]|ti|co
deítico	adjetivo	de|[í]|ti|co
deixa	nome feminino	[dei]|xa
deixá-lo	interjeição	dei|xá-lo
deixação	nome feminino	dei|xa|[ção]
deixada	nome feminino	dei|[xa]|da
deixado	adjetivo	dei|[xa]|do
deixar	verbo	dei|[xar]
dêixis	nome feminino	[dêi]|xis
déjà-vu	nome masculino	dé|'jà-vu
dejarretar	verbo	de|jar|re|[tar]
dejeção	nome feminino	de|je|[ção]
dejecção	nome feminino	de|jec|[ção]
dejectar	verbo	de|jec|[tar]
dejecto	nome masculino	de|[jec]|to
dejectório	nome masculino	de|jec|[tó]|ri|o
dejejua	nome feminino	de|je|[ju]|a
dejejuadoiro	nome masculino	de|je|ju|a|[doi]|ro
dejejuadouro	nome masculino	de|je|ju|a|[dou]|ro
dejejuar	verbo	de|je|ju|[ar]
dejejum	nome masculino	de|je|[jum]
dejetar	verbo	de|je|[tar]
dejeto	nome masculino	de|[je]|to
dejetório	nome masculino	de|je|[tó]|ri|o
dejum	nome masculino	de|[jum]
dejungir	verbo	de|jun|[gir]
dejúrio	nome masculino	de|[jú]|ri|o
delação	nome feminino	de|la|[ção]
delamber	verbo	de|lam|[ber]
delambida	nome feminino	de|lam|[bi]|da
delambido	adjetivo	de|lam|[bi]|do
delambido	nome masculino	de|lam|[bi]|do
delapidação	nome feminino	de|la|pi|da|[ção]
delapidador	nome masculino	de|la|pi|da|[dor]
delapidadora	nome feminino	de|la|pi|da|[do]|ra
delapidar	verbo	de|la|pi|[dar]
delatar	verbo	de|la|[tar]
delatável	adjetivo	de|la|[tá]|vel
delativo	adjetivo	de|la|[ti]|vo
delativo	nome masculino	de|la|[ti]|vo
delator	adjetivo	de|la|[tor]
delator	nome masculino	de|la|[tor]
delatora	nome feminino	de|la|[to]|ra
delatório	adjetivo	de|la|[tó]|ri|o
dele	contração	[de]|le
deleátur	nome masculino	de|le|[á]|tur
delebilidade	nome feminino	de|le|bi|li|[da]|de
deleção	nome feminino	de|le|[ção]
delegação	nome feminino	de|le|ga|[ção]
delegação-geral	nome feminino	de|le|ga|ção-ge|[ral]
delegacia	nome feminino	de|le|ga|[ci]|a
delegada	nome feminino	de|le|[ga]|da
delegado	nome masculino	de|le|[ga]|do
delegante	adjetivo	de|le|[gan]|te
delegante	nome masculino	de|le|[gan]|te
delegante	nome feminino	de|le|[gan]|te
delegar	verbo	de|le|[gar]
delegatário	nome masculino	de|le|ga|[tá]|ri|o
delegatório	adjetivo	de|le|ga|[tó]|ri|o
delegável	adjetivo	de|le|[gá]|vel
deleitação	nome feminino	de|lei|ta|[ção]
deleitado	adjetivo	de|lei|[ta]|do
deleitamento	nome masculino	de|lei|ta|[men]|to
deleitante	adjetivo	de|lei|[tan]|te
deleitar	verbo	de|lei|[tar]
deleitável	adjetivo	de|lei|[tá]|vel
deleitavelmente	advérbio	de|lei|ta|vel|[men]|te
deleite	nome masculino	de|[lei]|te
deleitosamente	advérbio	de|lei|to|sa|[men]|te
deleitoso	adjetivo	de|lei|[to]|so
deletar	verbo	de|le|[tar]
deletério	adjetivo	de|le|[té]|ri|o
deletrear	verbo	de|le|tre|[ar]
deleuzianamente	advérbio	de|leu|zi|a|na|[men]|te
deleuziano	adjetivo	de|leu|zi|[a]|no
delével	adjetivo	de|[lé]|vel
delfíada	nome feminino	del|[fí]|a|da
délfico	adjetivo	[dél]|fi|co
