desamalgamação	nome feminino	de|sa|mal|ga|ma|[ção]
desamalgamar	verbo	de|sa|mal|ga|[mar]
desamamentar	verbo	de|sa|ma|men|[tar]
desamanhar	verbo	de|sa|ma|[nhar]
desamanho	nome masculino	de|sa|[ma]|nho
desamantilhar	verbo	de|sa|man|ti|[lhar]
desamão	nome feminino	de|sa|[mão]
desamar	verbo	de|sa|[mar]
desamarrar	verbo	de|sa|mar|[rar]
desamarrotar	verbo	de|sa|mar|ro|[tar]
desamartelar	verbo	de|sa|mar|te|[lar]
desamassar	verbo	de|sa|mas|[sar]
desamável	adjetivo	de|sa|[má]|vel
desamavelmente	advérbio	de|sa|ma|vel|[men]|te
desambição	nome feminino	de|sam|bi|[ção]
desambiciosamente	advérbio	de|sam|bi|ci|o|sa|[men]|te
desambicioso	adjetivo	de|sam|bi|ci|[o]|so
desambientação	nome feminino	de|sam|bi|en|ta|[ção]
desambientado	adjetivo	de|sam|bi|en|[ta]|do
desambientar	verbo	de|sam|bi|en|[tar]
desambiguação	nome feminino	de|sam|bi|gua|[ção]
desambiguar	verbo	de|sam|bi|[guar]
desamear	verbo	de|sa|me|[ar]
desamedrontar	verbo	de|sa|me|dron|[tar]
desameno	adjetivo	de|sa|[me]|no
desamiantagem	nome feminino	de|sa|mi|an|[ta]|gem
desamigar	verbo	de|sa|mi|[gar]
desamigo	adjetivo	de|sa|[mi]|go
desamimar	verbo	de|sa|mi|[mar]
desamistar	verbo	de|sa|mis|[tar]
desamizade	nome feminino	de|sa|mi|[za]|de
desamodorração	nome feminino	de|sa|mo|dor|ra|[ção]
desamodorramento	nome masculino	de|sa|mo|dor|ra|[men]|to
desamodorrar	verbo	de|sa|mo|dor|[rar]
desamoedação	nome feminino	de|sa|mo|e|da|[ção]
desamoedar	verbo	de|sa|mo|e|[dar]
desamoldação	nome feminino	de|sa|mol|da|[ção]
desamoldar	verbo	de|sa|mol|[dar]
desamolgação	nome feminino	de|sa|mol|ga|[ção]
desamolgamento	nome masculino	de|sa|mol|ga|[men]|to
desamolgar	verbo	de|sa|mol|[gar]
desamolgável	adjetivo	de|sa|mol|[gá]|vel
desamontoação	nome feminino	de|sa|mon|to|a|[ção]
desamontoamento	nome masculino	de|sa|mon|to|a|[men]|to
desamontoar	verbo	de|sa|mon|to|[ar]
desamor	nome masculino	de|sa|[mor]
desamorado	adjetivo	de|sa|mo|[ra]|do
desamorável	adjetivo	de|sa|mo|[rá]|vel
desamoravelmente	advérbio	de|sa|mo|ra|vel|[men]|te
desamoroso	adjetivo	de|sa|mo|[ro]|so
desamortalhar	verbo	de|sa|mor|ta|[lhar]
desamortização	nome feminino	de|sa|mor|ti|za|[ção]
desamortizar	verbo	de|sa|mor|ti|[zar]
desamortizável	adjetivo	de|sa|mor|ti|[zá]|vel
desamotinação	nome feminino	de|sa|mo|ti|na|[ção]
desamotinar	verbo	de|sa|mo|ti|[nar]
desamparada	nome feminino	de|sam|pa|[ra]|da
desamparadamente	advérbio	de|sam|pa|ra|da|[men]|te
desamparado	adjetivo	de|sam|pa|[ra]|do
desamparado	nome masculino	de|sam|pa|[ra]|do
desamparador	adjetivo	de|sam|pa|ra|[dor]
desamparador	nome masculino	de|sam|pa|ra|[dor]
desamparar	verbo	de|sam|pa|[rar]
desamparinho	nome masculino	de|sam|pa|[ri]|nho
desamparo	nome masculino	de|sam|[pa]|ro
desamuar	verbo	de|sa|mu|[ar]
desanalfabetizar	verbo	de|sa|nal|fa|be|ti|[zar]
desancador	adjetivo	de|san|ca|[dor]
desancador	nome masculino	de|san|ca|[dor]
desancadora	nome feminino	de|san|ca|[do]|ra
desancamento	nome masculino	de|san|ca|[men]|to
desancar	verbo	de|san|[car]
desancorar	verbo	de|san|co|[rar]
desanda	nome feminino	de|[san]|da
desandadeira	nome feminino	de|san|da|[dei]|ra
desandadela	nome feminino	de|san|da|[de]|la
desandador	adjetivo	de|san|da|[dor]
desandador	nome masculino	de|san|da|[dor]
desandamento	nome masculino	de|san|da|[men]|to
desandar	verbo	de|san|[dar]
desando	nome masculino	de|[san]|do
desanelar	verbo	de|sa|ne|[lar]
desanexação	nome feminino	de|sa|ne|xa|[ção]
desanexar	verbo	de|sa|ne|[xar]
desanexo	adjetivo	de|sa|[ne]|xo
desanexo	nome masculino	de|sa|[ne]|xo
desanichar	verbo	de|sa|ni|[char]
desanimação	nome feminino	de|sa|ni|ma|[ção]
desanimadamente	advérbio	de|sa|ni|ma|da|[men]|te
desanimado	adjetivo	de|sa|ni|[ma]|do
desanimado	nome masculino	de|sa|ni|[ma]|do
desanimador	adjetivo	de|sa|ni|ma|[dor]
desanimador	nome masculino	de|sa|ni|ma|[dor]
desanimadora	nome feminino	de|sa|ni|ma|[do]|ra
desanimar	verbo	de|sa|ni|[mar]
desanimável	adjetivo	de|sa|ni|[má]|vel
desânimo	nome masculino	de|[sâ]|ni|mo
desaninhar	verbo	de|sa|ni|[nhar]
desanojamento	nome masculino	de|sa|no|ja|[men]|to
desanojar	verbo	de|sa|no|[jar]
