relevância	nome feminino	re|le|[vân]|ci|a
relevante	adjetivo	re|le|[van]|te
relevante	nome masculino	re|le|[van]|te
relevantemente	advérbio	re|le|van|te|[men]|te
relevar	verbo	re|le|[var]
relevável	adjetivo	re|le|[vá]|vel
relevo	nome masculino	re|[le]|vo
relevogravura	nome feminino	re|le|vo|gra|[vu]|ra
relfa	nome feminino	[rel]|fa
relha	nome feminino	[re]|lha
relhaço	nome masculino	re|[lha]|ço
relhada	nome feminino	re|[lha]|da
relhador	nome masculino	re|lha|[dor]
relhar	verbo	re|[lhar]
relhas	nome masculino	[re]|lhas
relhas	nome feminino	[re]|lhas
relheira	nome feminino	re|[lhei]|ra
relheiro	nome masculino	re|[lhei]|ro
relho	adjetivo	[re]|lho
relho	nome masculino	[re]|lho
relhota	nome feminino	re|[lho]|ta
relhote	nome masculino	re|[lho]|te
relicário	nome masculino	re|li|[cá]|ri|o
relice	nome feminino	re|[li]|ce
relicitação	nome feminino	re|li|ci|ta|[ção]
relicitar	verbo	re|li|ci|[tar]
relicto	nome masculino	re|[lic]|to
religar	verbo	re|li|[gar]
religável	adjetivo	re|li|[gá]|vel
religião	nome feminino	re|li|gi|[ão]
religiomania	nome feminino	re|li|gi|o|ma|[ni]|a
religiomaníaco	adjetivo	re|li|gi|o|ma|[ní]|a|co
religiomaníaco	nome masculino	re|li|gi|o|ma|[ní]|a|co
religiómano	nome masculino	re|li|gi|[ó]|ma|no
religiômano	nome masculino	re|li|gi|[ô]|ma|no
religionário	nome masculino	re|li|gi|o|[ná]|ri|o
religiosa	nome feminino	re|li|gi|[o]|sa
religiosamente	advérbio	re|li|gi|o|sa|[men]|te
religiosidade	nome feminino	re|li|gi|o|si|[da]|de
religioso	adjetivo	re|li|gi|[o]|so
religioso	nome masculino	re|li|gi|[o]|so
relimar	verbo	re|li|[mar]
relinchante	adjetivo	re|lin|[chan]|te
relinchão	adjetivo	re|lin|[chão]
relinchão	nome masculino	re|lin|[chão]
relinchar	verbo	re|lin|[char]
relinchar	nome masculino	re|lin|[char]
relincho	nome masculino	re|[lin]|cho
relinga	nome feminino	re|[lin]|ga
relingar	verbo	re|lin|[gar]
relinquição	nome feminino	re|lin|qui|[ção]
relinquimento	nome masculino	re|lin|qui|[men]|to
relinquir	verbo	re|lin|[quir]
relíquia	nome feminino	re|[lí]|qui|a
relocação	nome feminino	re|lo|ca|[ção]
relocalização	nome feminino	re|lo|ca|li|za|[ção]
relocar	verbo	re|lo|[car]
relógio	nome masculino	re|[ló]|gi|o
relógio de ponto	nome masculino	re|[ló]|gi|o de pon|to
relógio-calendário	nome masculino	re|ló|gi|o-ca|len|dá|ri|o
relógio-da-morte	nome masculino	re|ló|gi|o-da-mor|te
relógio-pulseira	nome masculino	[re]
relojar	verbo	re|lo|[jar]
relojeiro	nome masculino	re|lo|[jei]|ro
relojo	nome masculino	re|[lo]|jo
relojoaria	nome feminino	re|lo|jo|a|[ri]|a
relojoeiro	nome masculino	re|lo|jo|[ei]|ro
relojoeiro	adjetivo	re|lo|jo|[ei]|ro
reloucado	adjetivo	re|lou|[ca]|do
reloucar	verbo	re|lou|[car]
reloucura	nome feminino	re|lou|[cu]|ra
relouquear	verbo	re|lou|que|[ar]
relúcido	adjetivo	re|[lú]|ci|do
relumbrante	adjetivo	re|lum|[bran]|te
relumbrar	verbo	re|lum|[brar]
relustrar	verbo	re|lus|[trar]
relutação	nome feminino	re|lu|ta|[ção]
relutância	nome feminino	re|lu|[tân]|ci|a
relutante	adjetivo	re|lu|[tan]|te
relutantemente	advérbio	re|lu|tan|te|[men]|te
relutar	verbo	re|lu|[tar]
relutividade	nome feminino	re|lu|ti|vi|[da]|de
reluzente	adjetivo	re|lu|[zen]|te
reluzir	verbo	re|lu|[zir]
relva	nome feminino	[rel]|va
relvado	nome masculino	rel|[va]|do
relvagem	nome feminino	rel|[va]|gem
relvão	nome masculino	rel|[vão]
relvão	adjetivo	rel|[vão]
relvar	verbo	rel|[var]
relvedo	nome masculino	rel|[ve]|do
relvejar	verbo	rel|ve|[jar]
relvoso	adjetivo	rel|[vo]|so
rem	nome masculino	[rem]
rema	nome masculino	[re]|ma
remada	nome feminino	re|[ma]|da
remadela	nome feminino	re|ma|[de]|la
remado	adjetivo	re|[ma]|do
remador	adjetivo	re|ma|[dor]
remador	nome masculino	re|ma|[dor]
