repoisar	verbo	re|poi|[sar]
repoiseira	nome feminino	re|poi|[sei]|ra
repoisentado	adjetivo	re|poi|sen|[ta]|do
repoiso	nome masculino	re|[poi]|so
repolegar	verbo	re|po|le|[gar]
repolego	nome masculino	re|po|[le]|go
repolga	nome feminino	re|[pol]|ga
repolgar	verbo	re|pol|[gar]
repolhaço	nome masculino	re|po|[lha]|ço
repolhal	nome masculino	re|po|[lhal]
repolhal	adjetivo	re|po|[lhal]
repolhar	verbo	re|po|[lhar]
repolho	nome masculino	re|[po]|lho
repolhudo	adjetivo	re|po|[lhu]|do
repoltrear	verbo	re|pol|tre|[ar]
repôncio	nome masculino	re|[pôn]|ci|o
reponta	nome feminino	re|[pon]|ta
repontador	adjetivo	re|pon|ta|[dor]
repontão	adjetivo	re|pon|[tão]
repontão	nome masculino	re|pon|[tão]
repontar	verbo	re|pon|[tar]
reponte	nome masculino	re|[pon]|te
repontice	nome feminino	re|pon|[ti]|ce
repontona	nome feminino	re|pon|[to]|na
repontuar	verbo	re|pon|tu|[ar]
repopularizar	verbo	re|po|pu|la|ri|[zar]
repor	verbo	re|[por]
reportação	nome feminino	re|por|ta|[ção]
reportadamente	advérbio	re|por|ta|da|[men]|te
reportado	adjetivo	re|por|[ta]|do
reportagem	nome feminino	re|por|[ta]|gem
reportamento	nome masculino	re|por|ta|[men]|to
reportar	verbo	re|por|[tar]
reporte	nome masculino	re|[por]|te
repórter	nome masculino	re|[pór]|ter
repórter	nome feminino	re|[pór]|ter
reportório	nome masculino	re|por|[tó]|ri|o
reposição	nome feminino	re|po|si|[ção]
reposicionamento	nome masculino	re|po|si|ci|o|na|[men]|to
reposicionar	verbo	re|po|si|ci|o|[nar]
repósito	nome masculino	re|[pó]|si|to
repositório	nome masculino	re|po|si|[tó]|ri|o
repositório	adjetivo	re|po|si|[tó]|ri|o
reposta	nome feminino	re|[pos]|ta
repostada	nome feminino	re|pos|[ta]|da
repostar	verbo	re|pos|[tar]
repostaria	nome feminino	re|pos|ta|[ri]|a
reposte	nome masculino	re|[pos]|te
reposteiro	nome masculino	re|pos|[tei]|ro
reposteiro-mor	nome masculino	re|pos
repotrear	verbo	re|po|tre|[ar]
repotronar	verbo	re|po|tro|[nar]
repousadamente	advérbio	re|pou|sa|da|[men]|te
repousado	adjetivo	re|pou|[sa]|do
repousante	adjetivo	re|pou|[san]|te
repousar	verbo	re|pou|[sar]
repouseira	nome feminino	re|pou|[sei]|ra
repousentado	adjetivo	re|pou|sen|[ta]|do
repouso	nome masculino	re|[pou]|so
repovoação	nome feminino	re|po|vo|a|[ção]
repovoador	adjetivo	re|po|vo|a|[dor]
repovoador	nome masculino	re|po|vo|a|[dor]
repovoamento	nome masculino	re|po|vo|a|[men]|to
repovoar	verbo	re|po|vo|[ar]
repovoável	adjetivo	re|po|vo|[á]|vel
repreendedor	adjetivo	re|pre|en|de|[dor]
repreendedor	nome masculino	re|pre|en|de|[dor]
repreender	verbo	re|pre|en|[der]
repreendido	adjetivo	re|pre|en|[di]|do
repreendimento	nome masculino	re|pre|en|di|[men]|to
repreensão	nome feminino	re|pre|en|[são]
repreensivamente	advérbio	re|pre|en|si|va|[men]|te
repreensível	adjetivo	re|pre|en|[sí]|vel
repreensivelmente	advérbio	re|pre|en|si|vel|[men]|te
repreensivo	adjetivo	re|pre|en|[si]|vo
repreensor	adjetivo	re|pre|en|[sor]
repreensor	nome masculino	re|pre|en|[sor]
repreensora	nome feminino	re|pre|en|[so]|ra
repregado	nome masculino	re|pre|[ga]|do
repregado	adjetivo	re|pre|[ga]|do
repregar	verbo	re|pre|[gar]
reprego	nome masculino	re|[pre]|go
reprender	verbo	re|pren|[der]
reprensão	nome feminino	re|pren|[são]
represa	nome feminino	re|[pre]|sa
represada	nome feminino	re|pre|[sa]|da
represador	adjetivo	re|pre|sa|[dor]
represador	nome masculino	re|pre|sa|[dor]
represadura	nome feminino	re|pre|sa|[du]|ra
represália	nome feminino	re|pre|[sá]|li|a
represamento	nome masculino	re|pre|sa|[men]|to
represar	verbo	re|pre|[sar]
representação	nome feminino	re|pre|sen|ta|[ção]
representador	adjetivo	re|pre|sen|ta|[dor]
representador	nome masculino	re|pre|sen|ta|[dor]
representante	adjetivo	re|pre|sen|[tan]|te
representante	nome masculino	re|pre|sen|[tan]|te
representante	nome feminino	re|pre|sen|[tan]|te
representar	verbo	re|pre|sen|[tar]
representativa	nome feminino	re|pre|sen|ta|[ti]|va
