nudibrânquio	nome masculino	nu|di|[brân]|qui|o
nudicaude	adjetivo	nu|di|[cau]|de
nudicaule	adjetivo	nu|di|[cau]|le
nudifloro	adjetivo	nu|di|[flo]|ro
nudifólio	adjetivo	nu|di|[fó]|li|o
nudíparo	adjetivo	nu|[dí]|pa|ro
nudípede	adjetivo	nu|[dí]|pe|de
nudismo	nome masculino	nu|[dis]|mo
nudissexo	adjetivo	nu|dis|[se]|xo
nudista	adjetivo	nu|[dis]|ta
nudista	nome masculino	nu|[dis]|ta
nudista	nome feminino	nu|[dis]|ta
nuditarso	adjetivo	nu|di|[tar]|so
nudiúsculo	adjetivo	nu|di|[ús]|cu|lo
nuelo	adjetivo	nu|[e]|lo
nuer	nome masculino	nu|[er]
nuer	adjetivo	nu|[er]
nuer	nome feminino	nu|[er]
nueza	nome feminino	nu|[e]|za
núfar	nome masculino	[nú]|far
nuga	nome feminino	[nu]|ga
nugação	nome feminino	nu|ga|[ção]
nugacidade	nome feminino	nu|ga|ci|[da]|de
nugas	nome feminino	[nu]|gas
nugativo	adjetivo	nu|ga|[ti]|vo
nugatório	adjetivo	nu|ga|[tó]|ri|o
nuítone	adjetivo	nu|[í]|to|ne
nuítone	nome masculino	nu|[í]|to|ne
nuítone	nome feminino	nu|[í]|to|ne
nulamente	advérbio	nu|la|[men]|te
nulidade	nome feminino	nu|li|[da]|de
nulificação	nome feminino	nu|li|fi|ca|[ção]
nulificante	adjetivo	nu|li|fi|[can]|te
nulificar	verbo	nu|li|fi|[car]
nulificativo	adjetivo	nu|li|fi|ca|[ti]|vo
nulificável	adjetivo	nu|li|fi|[cá]|vel
nulinerve	adjetivo	nu|li|[ner]|ve
nulípara	nome feminino	nu|[lí]|pa|ra
nulípara	adjetivo	nu|[lí]|pa|ra
nulíparo	adjetivo	nu|[lí]|pa|ro
nulivalente	adjetivo	nu|li|va|[len]|te
nulo	adjetivo	[nu]|lo
nulo	nome masculino	[nu]|lo
num	contração	[num]
numantino	adjetivo	nu|man|[ti]|no
numantino	nome masculino	nu|man|[ti]|no
numária	nome feminino	nu|[má]|ri|a
numário	adjetivo	nu|[má]|ri|o
numbela	nome feminino	num|[be]|la
nume	nome masculino	[nu]|me
númen	nome masculino	[nú]|men
numenal	adjetivo	nu|me|[nal]
numénico	adjetivo	nu|[mé]|ni|co
numênico	adjetivo	nu|[mê]|ni|co
númeno	nome masculino	[nú]|me|no
numeração	nome feminino	nu|me|ra|[ção]
numerado	adjetivo	nu|me|[ra]|do
numerador	adjetivo	nu|me|ra|[dor]
numerador	nome masculino	nu|me|ra|[dor]
numeradora	nome feminino	nu|me|ra|[do]|ra
numeral	adjetivo	nu|me|[ral]
numeral	nome masculino	nu|me|[ral]
numeralmente	advérbio	nu|me|ral|[men]|te
numeramento	nome masculino	nu|me|ra|[men]|to
numerar	verbo	nu|me|[rar]
numerário	nome masculino	nu|me|[rá]|ri|o
numerário	adjetivo	nu|me|[rá]|ri|o
numerativo	adjetivo	nu|me|ra|[ti]|vo
numerável	adjetivo	nu|me|[rá]|vel
numéria	nome feminino	nu|[mé]|ri|a
numericamente	advérbio	nu|me|ri|ca|[men]|te
numérico	adjetivo	nu|[mé]|ri|co
número	nome masculino	[nú]|me|ro
numerologia	nome feminino	nu|me|ro|lo|[gi]|a
numerológico	adjetivo	nu|me|ro|[ló]|gi|co
numerólogo	nome masculino	nu|me|[ró]|lo|go
numerosamente	advérbio	nu|me|ro|sa|[men]|te
numerosidade	nome feminino	nu|me|ro|si|[da]|de
numeroso	adjetivo	nu|me|[ro]|so
númida	nome masculino	[nú]|mi|da
númida	adjetivo	[nú]|mi|da
númida	nome feminino	[nú]|mi|da
numídico	adjetivo	nu|[mí]|di|co
numidídeo	nome masculino	nu|mi|[dí]|de|o
numidídeo	adjetivo	nu|mi|[dí]|de|o
numidídeo	nome masculino	nu|mi|[dí]|de|o
numiforme	adjetivo	nu|mi|[for]|me
numinoso	adjetivo	nu|mi|[no]|so
numisma	nome masculino	nu|[mis]|ma
numismal	adjetivo	nu|mis|[mal]
numismata	nome masculino	nu|mis|[ma]|ta
numismata	nome feminino	nu|mis|[ma]|ta
numismática	nome feminino	nu|mis|[má]|ti|ca
numismaticamente	advérbio	nu|mis|ma|ti|ca|[men]|te
numismático	nome masculino	nu|mis|[má]|ti|co
numismático	adjetivo	nu|mis|[má]|ti|co
numismatista	nome masculino	nu|mis|ma|[tis]|ta
numismatista	nome feminino	nu|mis|ma|[tis]|ta
numismatografia	nome feminino	nu|mis|ma|to|gra|[fi]|a
numismatográfico	adjetivo	nu|mis|ma|to|[grá]|fi|co
